XXOXOXOXOXOOXOOXOOOOOXOXX
OOOOOXXXOOOOXXOOOOOOOOOOO
OXOOXOOOOXOOOOXOOXOOOOOOO
XOOOOXOOXOOOOXOOOOOOOOOOO
OOOOOOOOOOOOOOOOOOOOXOXOO
OOOOOXOOOOOOOOOOOOOOOOOXO
XXOOOOOOOOOXOXOOOOXOOOOOF
OXOOOOXOOOOOOOOOOOOXOXOOO
XOOOXOOOXOOOXXOOOOOOOOOOO
OOOOOOOOXXXOOXXXXOOXOOOOO
OOXOOOOOOOOOOXOOOOOOXOOOX
XOOOOOXOXOOOXOOXOOOOOOXOO
OOOOOOXOOOOOOOOOXOOOXOOOO
OOOOOO*OOXOOOOXOOXOOOOXOO
OOOOOOOOOOOOOOOXXOOXOOOOO
OXXOOOOOOOOOOOOOOOXXOOOOO
OOOOOOXOOOXOOOOXOOOXXOOOO
XOOOOOOOOOOOOOXXOOXOOXOOO
OOOOOOOXOOOOOOOOOOXOOOOOO
XXOOOOXOXOXOOOOOOOOOOXOOO
OXXOOOOXOOOOOOOOOXOOOXOOO
XOOOOXOOOOOXOOOOOOOOOOOOO
OOOOOXXOOXOXOOOXOOOOOOOOO
OOOOXOOOOXOOOOOOXOOOOOOOO
OOOXOOOOOOOOXXOOXXXOOOOOO
