XOOOOOOOOOOOOXOOOOOOOOOOOOOOOOOOOXOOOOOOOXXXOOOOOOOXOOOXOOOOOOOOOOOOXXXXOOOXXXOOOOOXXOOOXOOOOOOOOOOO
OOOXXOOXOOOOOOOOOOOOOOOOOOOXXOXOOOOOOOOOOOOOOOXOOOOOXOOOXXOXOOOOOXOOOOOOOOOOOXOOOOOOOXOXOXOOOOOXOXXX
OOOXOOXOOOOOOOOOOXOOOOOOOOOOOOOOOOOOOOOOOOXOOOOOOOXOOOOOOOOOOXOOOOOOXOOOOOXOOXOOOOXOOOOXOOOOOXOXXOOO
OOOXOOXXOOOXOOOOOOOOOOXXOOOOOOOOOOOXOOOXOOOOOOOOOXOXOOOOXOXOXOXOOOOOOOOXOXOOOOOOXOOOOOOOOOOOOOXXOOOO
OOOOOOOOOXOOOXOOOOOOXOOOOOOOOOXOOOOXOOXOXXXXOOOOOOOOOOOOOOOOOOXOOOOOOXOOOOOOOOXOOXOXOOOOXOXOOOOOOOOO
XOOOXOOOOOOOXOOOXOXOXOOOOOXOXOOOOOOOOOOOOOOOXOXXOOOOOOOOOOXOOXOOOOOOOOOOOOOOOOOOOOOOOOOOOOOOOOOOOOOO
OOOOOXOOXOOOOOXOXOOOOOXXOOOOOOOXOOOOOOXOOOOOOXOOOOOOOOXXXOOXOOOOOOXOOXXOOOOXOOOXOOOOOOXOOOXOOOXOOXOX
XOOOOXOOOOOOXOXOOOOOXOXOOOOXOOOOXOOOOOOOOOOOOOOOOOXOOOOOOOOOOOOXOOOOOOOXOOOOOOOOOOOXOXXOXOOXXOOOOOXO
XXOOOXOOOOXOOOOOOOXOOOOOXOOOOOOXXOOXOOOXXOOOOXXOOOOOOOOOOOOXOOOOOOOOXOOOXOOOOOOOXOOOXOOOOOOOXXOOOOOX
OOOOOOOOOXOXXOOOOOOOOOOOOOOOOOOXOXOOOOOOOXOOOOOOOOXXOXOOOOOOOOOOXXOOOXXOOOXXOOXOOXXOXOOOXOXOOOOXXOOO
OOOOOXOOOOOOOOOOOOOOOOOXOXOOOOOOOOXOOOOOOXOOOXOOOOOXXOXOOOOOOOOOOOOOOXOOOXOXOXXOOOOOOOOOOOOOXOXXOXXO
OOOOOOOOOOOOOOOOOOOOOOOOOOOOXXOOOXOOOOOXXOOOOOOOXOOOOOOOXOOOXOOOOOOXOOOOOOOOOOOOXOOOOOOOOXXOOOOOOOOO
XOXXOOOOOOOOOOOOOOOXOOOXXOOOOOOXOOXOOOXXXOOOOOOOOOOOOOOOXXOOOXOOOOOOOOOOOOOOXOOOOOOXOOXOXOXOOOOOOOOO
OOOOOOOOOOOOOOOOXOOOOOOXOOOOOXOOOOOXOOOOOXOOOOOOOOOOXOOOOOOOOOOXOXOOXXOOOOOOOOOOOOOXOOXOXOOXOXOOOOOX
OOOOOOOXOOOXXOOOOOOOOOOXOOXOOXOOOOOXOOOOOOOOOOOOOOOXXOOOOOOOOOOXXOXXOOOOOOXOOOOOOOOOOXXOOOOXOOXOOOXO
OOOOOXXOOOXXOXXOOXOOOOOOOOOOXOOOOOOOXOXOOXOOOOOOOOOOXOOXOOXOOOOOOOXOOOOOOOOOOOOOXOOOXOOOOOXOXOOXOOOO
OXOOOOXOOXOOOOOOOOOOXXOXOOOOOOXOXOOOOOXOXOOOOOOXOOXOOOOOOOOOOOOOXOOOOOOOOOOXOOOOOXOXOOOOOXOOOOXOOOOO
OOOOOOOOOOOXXOXOOOXOOOOOOOXOOOOXOOXOOOXOOXOOOOOOXXOOOXXOOOOOOOOOOOOOXXOOOXOOOXOOOOOXOOXOOOXOXXOXXOOX
OXOOOOOXOOOOOOOOXOXOXOOOOOOOOOOXXOOOOOOXXOOOOOOXXXOOOOOOOOOOOOOOOOOOOOOOOOOOOOOXOOOXOOOOOXOXOOOOXOXO
OOOOOOOOXOOXOOOOOOXOOOOOOXOXOOXXXOOOOXOOOOOXOXOOOOOOOOOOOOOOXOOOOOXOOOOOOOOOXOOOXOOOOOOXOXOXOOXOOOOO
OXOOOXOOOOOOOXOOOOOOOOOOXOOXOOOXOXOOOOOOOXOOOOOOOXOOOOXOOXXOOOOOOOXXOOOXOXOOOXXXOXOXOOOOOOOOOOXOOOOO
XOOOOXXOOXOXOOOOXOOOOOXXOOOXOOOOXXOOXOOOOOOOOOOOOOOOOOOOOOXOOOOXOXOOOOOOOOOOOXOOOOXOOOOXOOOOOOOOXOOX
OOOOOOOOOOOOOOOOOXOOOOOXOOOOOOXOOXOOXOOOXXOOXOXOOOOOOOOOOOOOOOOOOOXXOXOOOOOOOOOOOOOOXOXOOOOOOOOXOXOO
OOOOOOOOOXXOOOOOOOOXOOOXOXXOOOOOOOOOOOOOXXOOOOOOOXOOOOXOOOOOOOOOOXOOOOOOOOOOOOOOOOOXOOOOOOOOOOOOOOOO
OOXOOOOXOOOOXXOOOOOOOOOOOOOOOOOOOOOOOOOXOXXOOOOOOOOOOOOOOOOOOOOXOOOOOXXXOOOOOOOOOOOOOOOOOOXOOOOOOOOO
OOOOOOXOXOXOOOOXOOOOXOXOOOOOXXOOOOXOOOOOOOXOOXOXOOOOOOOOXXXOOOOOXOOOXOOOOOOXOXOOOXOOOOOXOXXOOOOOOOOO
OOOOOOOOOOOXOOOOOOOOXOOOOXOOOXOOXOOOXOOOOXOOOOOXOOOOOXOOOOOOOOXOOOOOOOOOOOOOOOOOXOXOOOOXOOOOOXOOOOOX
OXOOOXOOOOOOOOOXXXXOOXOOOOOOOOXXOXXOOOOOXOOXOXOOOOOOOOOOOOXOOXOOOOXXOOOOOOXOXOOOXOOOXOXOOOOOXOOOOOOX
OXOOOOOXOOXXXOOOOXOXOXOOOOOXOXOOOOOOOOOXOOOOOOOOOOOXOOOOXOOXXOXXXOOOOOXXOOOOOOOOOOOOOOOOOOXOOOOOOOOO
OXOOOOOOOOOXOOXXOOOOOOOXOOOOOXOOXOOOOOOOOOOOOOOXOOOOOOOOOOOOOOXOOOOOOOXOOOOOOOOXOOXOOOOOOOOOOOOOOOOO
OOOOOOOOOOOOOOOOOOXXOOOOOOOOOOOOOOXXOOOOOOOOOOOOOOOOXOOXOOOOXOOOOXOOOXOOOOOOXOOOOOOOOXOXOXOXOOOOOOOX
OOOOXOOOOOXXOOXOOOOOXOOOOOOOOXXOOXOXOXOOOOOXOOOOXOOOXOOXOXOOXOOXXXXOOXOOXOXOOOOOOXOXOOOOOXOOXOOXOOOO
OOOOOOOOOOOOOOOXOOXOOOOXOOXOOOOOOXOOXXOOOOOOOOOOOXOOOOOOOOOXOOOOOOOXOOOOOOOOOOXOOOOXOOOOOOOOOOOOXXOX
OOXXOOOOXOOOXOOOOOOOOOOOOOOOOOOOOOOXOOOOOOOOXXOOOOOOOOXOOOOOOOOOOOOOOOOOOOXOOOXOOOOOOOOOOOOOOOOOOOOX
OOOOOXXOOOOOOOXOOOOOOOXOOOXOOOOOXOOOOOOOOOOOOOXOOOOOOXOXOXOOOOOOOOOOOOOOOOOOOOXOXOOOXOOOOOOOOOOOXXOO
OOXOOOOOOOOOOXXOXOOOXOXOOOOOOXOOXOXOOOOOOXOOOOOOOOOOOOOOOOOOOOOOOOXOOXOOOOXOXOOOOOOXOOOOOOOXXXOOOXOX
OOOXXOOOOXOXOXOOOOOOOXOXOOOOXXXXOOXOOOOOOOXOOOOOOOOXOOXXOOOOOXXOXOXOOOOOOOOOXOOXOXOXOOOXOXOOOOOOOOXO
OOXXXOOOOOOOXOXOOOOOOOOOOOOOXOOOOOOOOOOOOOOOOXOOOXOOOOOOOXOOOOOOOOOOOOOXXOOXOOOOOOOOOOOOOXOOOOXXOXXO
OOXOOOXOXXOXOOXOOOXXOOOOOOOOOOOXOOOOOOOOOOOOOOOOOOOOXOOXXOOOOOOOOOOOOXXOXOOOXOOOOOOOOOOXOOXXOOOOOOOO
OOOOOOXOXXOOXOXOOOOOOOOOOOXOOXOOOOXOOOOOOOOOOOOOOOOOOOOOXOOOOOOOOOXXOOOOOOOOOOOXOOOOOOOOOXXOOOOOOOOO
XOXOOOOOOOOOXOOOOOOOOOOOOOOXOOOOOXXOOOOOOOOOOOOOOOOOOOXOOOOXOOXOOOOOOXOOOOOOOOOOOOOOOOOOXOOOOOOOOOOO
OXOOOOOOOXOOXOOOOXOOXOOOOOOOOOXOXOOOOOXXOOOOOOOOXOOOOXOOXOXOXOOOOXOOOXOOOOOOOOXOOOXOOOOXOOOXOOOOOXOO
OOOOOOXXOOOOXOXOOXOOOOXOOOXOOOOOOXOOOXOOOOOOOOOOOOOOOOOOOOOOOOOOOXXOOOOXOOOOOOXOOOOOXOOOOXOOOXOOXXOO
OOXOOXOOOOOOOOOXXOOXOXOOXOOXOOOOOXXOXOXOOOOOXOOOOXOOOOOOOOOOOXOOXOOOXOXXOOXOOOOOOOOOOOOOOOOOOOOOOOOO
XXOOOOOXOXXOOOXOOOOXOOXOOOOOXOOOOOXXOOOXOOXOXOOXOOOOOOOOOOOXOOOOOOXXOOOOOXXOOXXOOXXOXOOOOOOOOOXOXOOO
OOOOOOOOXOOOOOOOOOOOXXOOOOXOXOOOOOOOOOOOOOOOOOOOOXOOOOOOOOXOOXOOXOXXXOXOOOOOOOXOOOOOOXOOOXXOOXOXXOXO
OOOOOOOOOOOOOOOOOOOOOXOOOXOOOOXOOOOXOOXXOOOOOXOOOOOOOXOOOOXXOXOOOOOOOOOOOOXOOOXOOOOOOOOOXOOOOOOOOOOO
OOOOOOOOXXXOXXOOOOOOOOOXOOXOOOOOXOOOOOOXOOOOXOOOOXOOOOXOOOOOOOOXOOXOOOOOOXOXOOOOOOOXXOOOOXOXOOOXOOOO
OOOOOOOOOOOOXXOXXOXOOOOXXOOOOXOOOOOXOOXOOOOOOOOOOOOOXOOOXOOOOOXOOOOOOOXOOOOOOOXOOOOOXOXOOOOOOOOOOOOO
OXOOXOXXOOOXOOOOOOOOOOOOOOOOXOXOOOOXXOOOOOOOOOOXXOXOOOOOOOOOOXOOOOOOOOOOOXOOOOOOOOOOOOOOOOOXOOOXOOOO
OXXOOOOOOXXOOOOOOOOOOOXOOOOOOOOOOOOOOOOXOOOOXOOOOOOOOXOXOOOOXOOOOOOOOOOOOOOOXOOXOOOOOOOOOOOOXOOOOXOO
OOXOOOOOOOOXOOOOOOXOXOOOOOOOOOXOOOOOOOOOOOOOOOOOOOOOOOOOOOOOOXOOOXOOOXXOOOOOOOOOOXOOOXOOXOOOXXOOOOOO
OOXOOOXXOOOOOXOOOOOOOOOOOXOOOOOOOOOXXOOOOXOXOXOOOOOOXOOOOXXXOXOXXOOXXOOOXOOOOXOOOOOOOOOOOXOOOOOOXOOX
OOOOXOXXXOOOXOOXOXOOOOOOOOOXOXXOOOOOXOOOOOOOXOOOOXOOXOOOOXOOXOOOOOOOOXOOOOXOXXOOOOOOXOOXOOOOOOOOXOOO
OOXOOOOOOOXOOOXOOOOOXOOOOOOXOOOOOOOOOOOOOOOOOOOOOOOOOOOOOOOOOOOOOOOOOOXOOOOOXXOOOOOOOXOOOOOOOXXOOOOO
OOOOOXOOOOOOXOOXXXOOOOOOOOOOXXXOOOOOOOOOOOOXOOOOOOOXOXOOOOOXOXOOOOOOOOOXOOOOOOOOOOOOOOOOOOOOXOOOOOOO
OOOOOOOOOOOOOXOOOOOOOOOOOOOOOOOOOOOOOOOOXOOOXOOOOOXOXOXOOOOOXOOXOXOXOOOOOXOOXOOOXOOOXXXOOOOOOOOOOOOO
OOOOOOOOOXOXOOOOOOOOOOOOOOOOOOOOOOOOOXXXOOOOOOOOOOOOXOXOOOOOOXXOOOOOOOOXOXOOOOOOXOXOOOOOXOOOOOOOOOOO
XOOOXXOXOOOXOOOOOOOXXOOXOOOX*OOOOOOXOOOOXOOOOOOOOOOOXOXOXOOOOOOOOOOOOXXXOXOOXOXXOOXOOOOOXOOOOOOOOOXO
OOOOOOOOOOOOOOOOOOOOOOOOOOOOOOOOOXOOOOOOOOXOOOOOOOOOXOXOXOOXOOXOXOOOOOOOOOOOXOOOXXOOXOOOXOOOOOXOOOXO
OOOXXOOOXOOXOOOOXOXOOXOOOOOOOOXOXOOOOOXXOOOOOOXXOOOOOXOOOOOOXOXOOOOOOOOOOOOOOXOOOOOOOOOOOOXOOOOOOOOO
XOOOOOOOXOOOOOOOOXOOXOOOOOOOOOOOOOOOOXOOOOOOOOOOOOXOOOOOOOOOOOOXOOOOOOOOOOXOXOOXOOOOOOOOOOOOXOOOXOOO
OOOOOXOOOOOOOXOOXOOOOOOXXOOOOOOOOOOOOOOOOOXOOXOOOOOXOOXOXOOXOOXOXOOOXOOOXOOOOOOOXXOOOOOOXOOOOOOOOOOO
OOXOOOOOOOOOOOOOOOXOOOXXXOOOOXOOOXOOXOOOOOOOOXXOOXOXXOOOOOOXXOOOXXOOOOOOOXOXOOXOOOXOOOOOOOOXOOOOOXOX
XOXOOOOOOOOOOOOXOOOOOOOOXXOOOXOOOXOOOOOOOOOOOXOXOOXOOOOXOOXOOOXOOOOOOOXOOOOOOOOOXOOOOXXOXOXOOOOOXOOO
OOOOOOOXOOOXOOXOXOOOOXOOOOOOOXOOOXOXOOOXOXOOOOXOOXOOOOOOXOOOOOXOOOOOOOOXOXOOOOOOXOOOOOXOOOOOOOXOOOXO
OOOXXOXOXOOXOOOOXOOOOOOOOOOXOXOOOOOOOXOOOOOOOOOOOOOOOOXOOOOOOOOOOOOOXOOOOXOXXOOOOOOOOOOOOOXOXOOXOOOO
XOOOOOOOXOOXOOXOOXXOXOOOXOOXOOOXOOOOOOXOOOOOOOOXOXOOXOOOOOOXOXOXXOOXOXOOOXOXXOOOXOOOOXOOOXOOOOOOXOOO
OOOOOOOOOOXOOOOOXOOOXXOOOOOOOOOOOOOOOOXOXOOOOOOOOOOOOOOOOXXOOOXOOXOOXXOOOOOOOOOOOOOXOOOOOOOOXOXXOOXO
OOOOOOOXOXXOOOXOOXOOOOOOOXXOXOOOOOOOOOOOOOOOOOOOOOOOXOOXXOOOXOOOOXOOOOOOOOOOOOOOOOOOOOOOOOOOOOOOOOOO
OOOOXOOOXOOOOOOOOXOXOOOOOOOOOOXXXOXOOOOXOOOOXOOOXXOOOOOOOOXOOXXOOOOOOOOOXOOOOXOOOOOOOOOOOOOOOOOOOOOO
OOOOOXXOOXOXOOOOOXOXOOOXOOOOOOOOOOOOOOOOOOOOOOOOOOOOOOOXXOOOFOOXOOOOXOOXOXOOXOOOXXOOOOOOOOOOOOOXOOOO
OOOOOOOXXXOXOOOXOXOOXOOXOOOOOXXOOXOOXXOOOOOXOOOOOOOOOOOOOOXOOOOOOOOOXXOOOOOOOOXOOOOOOOOXOOXOOOOOOOOO
OXOOOOXOOOXXXOOOOOOOXXOOOOOOOXOXOOOXOOOXOOXOOOOOOOOOOOXOOOOOOXOXOOXOXOOOOOXOOOOOOOOOOOOOOOOXXOOOOXOO
OOOXOOOXXXOOOOOOOOOXOOXOOOOOOOOOOXOXXOOOOOOOOOXOXOOOOXOOOOOOOXXOOOOOOOOXOOOOOOXOOXOOOOXOXOOOOOOOXXOO
OXXOOOOOOOOXOOXOOXOOOXXOOOOOXXOOOXXOOOOOOOOOOXOOOOOOOOOOOXOOOOXOOXXOOXOXOXOOOOOOOOOOOOOXOXOXOOOOXOXO
OOOOOOOOXOOOOOXOOXOOOOOOOOOOOOOXOOXXXOOOOOOXOXOOXOOOOXOXOOOOOXOOOOOOOOOOOOOOOOOXOOOOOOXOXOOOOOOOOOXO
OOOOXOXOOOOXOOXOOOXXOOOOOOOOOOOOOOOOOOOXOOXOOOOOOOOOXOOOOXOOXOOOOOXOXOOOOOXOOOOOOOOXOOOXOOOOOOOOOOOO
OOOOOOOOOOXOXOXXOXOOOOOOXOOOXOOOOOOOOOOOOOOOXOXOXOOOOOOOXOOOOOOOOOOOOOOXOOOOXOOOOOOOOOOOOOXOOXOOOOOO
XOOOOOOOXOOOOXOXOOOXXOOOOOOOOOOOOXOXOXOOOXOOOOOOOOOOOXOOOOOOOXOOOOXOOOOOOOOOOXOOOOXOOXOOOOXOOOOOOOOO
OOOOOOOOOOOOOXOOOXOOOXOOOXOOOOOOOOOXOOXOOXOXOOOOOOOOOOOOOOOOOOOOOOOXXOOOOXOOOOOOOOOOOOOOOOOOOXXOOOOO
OOOOOOOOOOOXOOOOXOOOOOXOOOOOOOOXOOOOOXOOOOOOOOXXXOXOOOOXOOOOOOXOOOOOOOXOOOXOOOOOXOXXXOOOXOOXOXOOOXOO
OOOOOXOOOOXXOOOOXOOXOOXOOOOXXOOOOOOOXXXOXOOOXOXOOOXOOXOOOOOOOOOOOOOOOOOOOOOOOOOOOOOOOOOXXXOOOOOOOOOO
XXOXOOXOOOOOOOOOOOOXOOOOOOXOOOOOOOOXOOOXOXXOOOOOOOOOOOOOOOOOXOOOXOOXOOOOOOOOXOOOOOOOOXOOOOOOOOOOOOOX
OOOOOXXOXOOOOOXOOOOOOOOOOOOOOOOOXOOOOOXOOOOOOXOOXOOOOOOOOOOOOOXOOXOOOOXXOOOOXOOOOOOOOOOOOOOOOOXOXOOO
OOOOOOOOOXOOOOOOOOOXOOOXOXOOOOOOOXOOOOXOOOXOOOOOOOOOOOOOOOOOOOXOOOOOOXOOOOOXOOOOOOOOXOOOXXXOOOOOOOXO
OOOXOOOOOOOOOOXXOOOXXOOOXXOOOOXOOOOOOOOOOOOOOOOXOOOOOOXOXOOOOOXOOXOOXOOOOOOXOOOXXOOOOOOOOOOOOOOOXXOO
OOOXOOOOXOOOOXOXOOOOOXOXOOOOOOOOXOXOOOXOOOOXOOOXXOOXOXOOOOOXOXOOXOXOOOOOOOOOOOOOOOOOOOOOOOXOOXOOOOXO
OOXOOOOOOOOXOOOXOOOOOOXOOOOOOOOXOOXOOOOOOOOXOOOOOOOOOOOOOOOOOOOOOOOOOOXOOOOOOOOOOOOOOOOOOOOXOXOOXOOO
OOXOOXOXOOOXOOOOOOOOOOOXOOOXOOOOOOOXOXOOOOOXOOOOOXXOOOOOOOOOOOXOXOXOOOOOOOOOOOOOXOOOOOOOOXOXOOXOXOXO
OOOOXOOOOOOOOOXOOOOXOOOOOXXOOOXOOOOOOOOOOOXOOOOOOOOOOOOXOOOOOOOOXOOOOOOXOOOOOOOXOOOOOOXOOOOOOOOOOOOO
XOOOOOOOOOOXOOOOXOOXOOOXOOOOOOOOOOOOOOXOOOOOOOOOOOOOOOOOOOXOOOOOOOXOXOOOOOXOOOOOOOOOOOXOOOOOOOOXOXOO
OOOOOOXOOOXOOOOOOOOOXXXOOOOOOOXOOOOOOOOOOOXOXOOOOOOOOOOOOOOOOOOOOOXOXOXXXOOOOXOOOXOXOOOOOXOXOOOXOOOO
OOOOOXOOOOOOXOOXOXOOXXOOOOXOXOOOOOOOOOOOOOOOOOXOOOOXOOOOOXOXOOOOOOOOOXOOOOOOOOXXOOOOXOOOXOXOOOXOXOXO
XOOOXOXOOOOOXOOXOOOOOOOOXOOOOOXOOXOXOOOOOOOOXOOOOOXOXOXOOOOOXOOOOOOOOOOOXOOOOXOOOOXOOXOXOOXOOOOXOOOO
OOOOOOXOXOOOXOXOOOOXXOXOOOOOOOOXOOOOOOOOOXOOOOOOOOOOXOOOXOOOXXOXOOOOXOXOOOOOOOOOOOOOXOXOOOOOOOXOXXOO
OOOOOOOOOOOOXOOOXOOOOOOOXXOXOOOXOXXOOOOXOOXXOOXOOOOOXOOOOOOXOOOOOOOOOOOOXOOXOOOOOXOOXXOOOOOOOXXOOOOX
OOXXOOOOXOOXOOOOOXOOXOXOOOOOOOOOOOOOXXXOOXOXXOOOOOOOOOOOOOOXOOOOOOOOOOOOOOXOOOOXOOOOOOOOOXXOOOOOXOOO
OOOOOOOOOXOXOXOOOOOOOOOOOOOOOOOOOOOOOOOOXOXOOXXXOOOOOOOOOXOOOOOOXOOXOOXOOOOOOOOOOOOOOXXOOXOOOOOOOOXO
OOOOOOOOOOXOOXOOOXOOOOOOOOOOOOOXOOOOOXOXOOXOOOOOOOOOOOOOOOXXXOOOOXOOOOOOOOOOXOXOOOXOOOOOOOOOOXOOOOOO
