OOOOOOOOOOOXOOOXOOOOXXOOOOXOOOOOOOOOOOOOXOXOXOOXOOOOXOOOXOOOOOOXOOOXOOOOOOXOOOOOOOOOOOOOOOOOOOOOOOXX
OOOXOOOOOOOOOXOXOOOOOOOOOOOOOOOOOOOOXOOXOOOOXOOOOOOXOOOOOOXXOOXOOOOOXXOOOOOOOOOOOOXOXOOOXOOOXOOOOOOO
OOOOOOOOOXXOOOOOOOOOOOOOOOXOOOOOOOOXXOOOXOOXXOOOOOOOOOOOOOOOOOOOOOXOXXOOOXOOOOOXOOOOOOOOOOOOXOOOOOXO
OOXOOOOOXOOXXOOOOOOOOOOXOOOOOXOXXOOOOOOOOOXOXOXOXOOOOOOOOOXXXOOOOXOOOOOOOOOOOXOOOOOOXOOOOOOXOXOXOOOX
XOOOOOOOOOOOOOOOOOOOXOOOXOOOOXOOXOOOOOOOXOOXOOOOOOOOXOOOOOXOOOOXXOXXXOOXOXOOOOOOOOOOOOXOOOOOOXOOOOOO
OOOOOXOOOOOOXOOOXOOOOOOOOOOOOOOOOOXOXOOOXOOOXOOOOOOXOOOOOOXXOOOXOOOOOXOOOOXOOOXOOOXOOOOXOOOOOOOXOOOO
OOOOXOOOOOOOOOOXOXOOXOOOXOXOOXOOOXOOXOOOXOOOOXOOOOXOOOOOOOXOOOOOOOOOOXOOOXXOXXXOOOXOOOXOOOOOOOOOOOOO
XOOOOXOOOOOOOOOOOXOOXOOOOOOXOOOOOOOOOOOXOOOOXXOOOOOOOOOOOXOOOOOOOXOOOXOOOOOOOOXOO*OXOXOOXOXOOOXXOOXO
OXOOOXXXXOXXOOOXOOOOOXOOOOOOXOOOOOOOOXOOOOOOOOOOOOOXXOOOOOOXXOOXOOOOOOOOOOOOOXOXOOOOOOOXOXOXOOOOOOOO
OXOOOOOOOOOOOOOOOOOOXOOOOOOXXOOOOXOOOOOOOOOOOOOOOOOOOOOOOOXOOXOXOOOOOXOXOOXOOOOOOOOOXOXOXOOOOXOOOOXX
OOOOOXOOOOOOOOOOOOXOOOOOOOXOOXXOOOOOOXOOXOXOXOOOOOOXOOXXOOOOOOXOOOXOXOOXOOOOOOOOOOOOOOOOXOOOOOXOOOOO
OXOOOOOOOOOXOOOOOOOOOOOOOOXOOOOOXOOOOXOOXOOXOOXOOXOOOXOOXOOOOOXOOXOOOOXOOOOXOOOOOOOOXXOOOOOXOOOXOOXO
XOOOOXOOOOOOOOOOOOOXOXOOOXOOOOXOOXOOOOOOXOOOOOOOOOXXOOOOXOOXOXOOOOOOOOOOXOOOOOOOXOOXOOOOOOXOOOOOOOOO
OOOOOOOOOOOOOOOOOOOOOOOXOOOOOOOOOOXOOOOOOOXXOOXOOOOXOOOOOOOOOOOOOOOOOOOOXOXOOOOOOXOOOOOXOOOOOOXXOOXO
OOOOOXOOOXOOOOXOOOOOXOOOOOOOOOOOXOOOOOOXOOXOOOOXOOOOOOOXOXOXOOOXOXOXXOOOXOOOOOOOOOOOXOOOOOOXOOXOOOOO
OOXOOOOXOXOOXOOOXOOOOOOOOXOOOOOOOOOOOOOOOOOXOOOOOOXOXOOXOOXOOOOOXXOOXXOOOOOOXXOOOOOXOOOOOOOOOOOOOOOX
OOXOOOOXOOOOOXXOOXOOOOXOXOOOOOOOOOXOOOXOOOOOOXOOOOOOOOXOOOOOOOOOOOOOXOOOOOOOOOXXOXXOOXOOOOOOOOOOOOOO
XXOXOOOOOOOOXOOOOOOOXOOOOOOOXOOOXOOOOOXXOOOOOOOOOOXOOOOXOXXOOOOOOOOOOOOOOOOOOOOXOOOOOOOXOOOOOOOOOOOO
XOOOOOOOXOXOOOOOOOXOOOOOOOOOOOOOOOOOOOOXOXOOXXOOXOOOOOOXXOOOOOOOOOOOOOOOOOOOXXOOOOOOXOXOOOOOOOOOOOOO
OOOOOOXOOOOOOOOOOXOOOXOOOOOXOOOOOOOOOOXOOOOOOOOXOOOOOOOOOOXOOOOOXXOOOOOOOOOOOOOOOOOOOOXOOXOXXXOOOOOO
XOOOOOOOOOXXOOOOOOOOXOOOOXOXXOOXXOOOOOOOOXOOOOOOOOOOOOOOXOOOOOOOOOOOOXXOOOOOOOOOOOOOOOXOOOOOOXOOOOOO
OOOXOXOOOOOOOOXXXOOOOOXOOOOXOOXOOOXOOOOXOOOOOOOOXOOOOOOOOOOOOOOXOXOOXOOOOOOOXOXOXOXXOOOOOXOOOXOOOOOO
OOOOOOOOXOOOOOOXOXOOOOOOOOOOOOOOXOOOOOOOOOOOOOOOOOOOOOOOOOOOOOOOOOXOOOOOOOOOOOXXOOOXOXXOOOOOOOXXOOXO
OOXOOOOOOOOOOOXOOOOOOOOXOXOOOOOOOOOOOOOOOOOOOOOOOOOOOOOOOOOXOOOXOOOXOOOOOOOOOOOOOOOOXOOOOOOOXOOOOXXO
OOXXOOXOOOOOOOOOOOOXOOOOOOOOOOOXOOOOOOOOOOOOOOOXOOOOXOOOOOOOXXOOOOOXOOXOOOOOOOOOOXOOOXOOOOOOOOOOOXOO
OOOOXOXOOOOOOOOOOOXOOOOOOOOOXOOOOOOXXOOOOOXOOOOOXOOOOOOOOOOOOXOXOOOOOOOOXXXXOXOOOOOOOOOOXXOOOOXOOXOO
OXOOOOOOOOOOOOOOOOOOOOOOOOOOOOOOXXOXOOOOOOXOOOXOOOOXXOOOOOOOOOOOOOOOOOOOOOOOOOOOXOOXOXOXOXOXXOOOOOOO
OOOOXOXOOOOOOOOOOOOOOOXOXOOOOXOXOOOXOOOXOOXXXOOOXXOOOOOXOXOOXOOOOXOOXOOXXOOOOOOOOOOOOOOOOOOOOXOOOXOO
OOOOOXOOXOOOOOOOOOOOXXOOOXOOOOOXXOOOOOOOOXOOOOOXOOOOOOOOXOOOXOXXOOOOOOOOOOXOOOOOXOOOOXOOOOXOOOOOOOOO
XOXOOOOXXOOOOOOOOOXXOXOOOOXOOOXOOXOOOXOXXXOXOOOOOOOOOOXOOOOOOOXOOOOXOXOOOOOOOOOOOOOOOOXOOOOOOOOOOOOO
OXOOOOOOOOOOOOOXOXOOXOOOOOOXOOOOOOOXOOXXOOXOOOOOOOOOOOOOOXXOXOOOOOOXOOOOOOOXOXOOOXOOOOOOOXOOOXOOOOOO
OXXXOOOOOOOOOOOOXXOOXOOOOXOOOXOOOOOOXOOOOOOOOOOOOOOOOOOOXOOOOOOOXOXXXXOXXXOOOXOOOOOOXOOOOOOOOOOOOXOO
OOOOOXOOXOOXOOOXXOOXOOOOOOOOOOOOOOOXOXOOOOXOOXOOOOOOOXOOXOOOXOOOOOOOOOOOOOOOOOOOOXXOXOXOOOOXOXXOOOOO
OOOOOXXOXOXOOOOOOOOXXOOOOOOOOOOOOXXOXXXXOXOXOOOXOOOOXOOXOOOOOOXOOOOOXOOOOOOOOOOOXOXOOXOOOOOOOOOOOOOO
XXOOXOOOOOOOOOOOOOOOOOOXOXOOXOOOOOOOOOOOOOXOOXOOOOOOOXOOOOOOOOOXOOOOOXOOOOOOOOOOOOOOOOOXOOXOXXOXOXOX
XOOOOOXOOOOOOOOOOOXOOOOXOXOXXOXOOOOXOXOXOOOOOOOOOOOOOOXOXXOOOOXOXXOOXXOXOOOOOOOOOOOOOOOOOOOOOOXOOOOO
OOOOOXOOOOOOOOOOXOOOOOOOOOXXXXOOXOOOOOOXOOXOOOOOOXOOOOOOOOOXOOOOOOOOXOOXOXOOOOXOOOOOOOOOOOXOOOXOOOXX
OOOOXOOXOXOOOOXOOOOOXOOXOOOOOOOOXXXXOOOOOXOOOOOOOXXOOXOOOOOOOOOOOOOOOOOOOOOOOOOOOOOOOXOOOXOOOOOOOOOO
OOOXXOOOOOOOOOOOOOXOOXOOXXXOXOOXOOOOOOOXOOOOOXOOOOOOXOXOOOOOOOOOOOOOOOXOOOOOOOOXOOOOOOOOOOOOOOOOOOOO
OXXOOOXOOOOXOOOOOOOOOOOOOOXOOOXOXOOOOOOOOOOOXOOXXOOOOOOOOXOOXOOOOOOOOOOOOOOOOOOOOOOOOOOXOOOOOOOOOOOX
OOOOOOOOOOOOOOOOOXOOOOOOOOXOOOOOOOOOOOOXOOOXOOOOOXXOOOOOOOOOOOXOOOOOOXXOOOXXOXOXOOOOOOOOOOXOOOOOXOOO
OXOOOOOOOOOOXOOOOXXOOOOXOOOOOOXOXOOOOXXOXOOOOOOXOOOOOOOOOOOOOOXOOOXOXXOOOXOOOOXOOOOOOOXOOOOOOOOOOXOO
OOXXXOXOXOOXOOXOOOXOOOOXOOOOOXXOOOOOOOOOOXOOOOOOOOOOXOXOOXOOOOOOOOOOOOOXOOOOOOOXXOOOOOOOXXOOOOOOOXOO
OOOOOOOOXXOOXOOXOOOOOOOOOOOOOOOOOOXOOXOOOOOOOXOOOOXXOOXOOXOOXOOOOOOOOOOOOXOOOOOOOOOXOXXOOOOOOOOOXOOO
OXOXOOOOXOXOOOOOOOOOXOXOXOXOOOXOOXOOOOXOOOOOOOOOOOOOOOOOOOOOOOOOOOOOOOOOOOOOOOOOOOOXOOOOOOOOOOXOOOOO
XOOXOOXOOOXOOOOOXOXOXOOOOXOOOOOOOOOOXXOOOOXOXOOOOOOOOOOOOOOXOOXOOOOOOOOXOOXOOXOOOOXOOXOOOOOXOOOOXXOO
OOOOOOOOOOOOXOOOXOOOOOOXXOXOOOOOOOOOOXOOOOOOOOOXOOOOOOOOXOOXOOOOOOOXXOOOOOOOOOXOOOOXOOOXOOXOOXXOOOOO
OXOOXOOOOOOXOOOOOOOXOOOOOOOOOOXOOOOXOXOOXOOOOXXXXXOOOOOOOXOOOOOOOOXOOXXOXOOOOOOXOOOOOOOOOOOOOOOOXOXO
OOOOOOOXOOOOOOOOXXOOOOXXOOOOOOOXOXOOOXXOOOOOOOOOOOOOOOOOOOOXOOOOXXOXOOXOOOXOOOOOXXOOOXOOOOOOOXOOOOOO
XOOOXOOOOXOOOOOOOOOOOOOXOOOOXOOOOOXOOOOOOXOXOOOOOOOOOOOOXOOOOOOXOOXOOOOOOOOOOXOOOOOOOOOOOOOXXXOOOXOO
OOOXOXXOXXOXOXOOOXOOOOOOOOOXOOOOOXOOOOXOOOXOOOOXOOOXOXOOOOOOOOOXOOOOOXOOOOOOOOOXOOOOOOOOOOXOXOOOXOOO
OOXOOOOOOOOOOOXOOOXOOOXOOOOXOOOOOOOOOOOXOOXOOOOOOOOXOOOOOOXOOOOOOOXOOXOOOOOOOOOOOOOOOXXXOOOOOOOOOOXO
OOXXOOOOOOOXOOOOOXOOOOOOXOOOOOXOOOOOOXOOOOOOOXOXOOOOXOOOOOOOOOOOOXXOOOOOOXOOXOOOXOOXXOOOOOOOOOOOOOOO
OXOOOOOOOOOOXOOXXOOOXOXOXOOOOOOOOXXOOOOOOOOOOOOOOOOOOOOXOOOOXOOXOOOOOOOOXOOOOOOOXOOOXOOOOOOOXOOOOXOO
OOOOXOOOXXOXOOOOOOOXOOOOOXOOOOOOOXOOOOOXOOOOOOOOXOOOOOOOOOOOXOXXOOOXOOOOOOOOOOXOOXOOOXOOOOOOOOOOOOOX
OOOOOOOXOXXOXOXOXOOOOOOXOOOOOOOOOOOXOOOOXXOOOOXOOOOOOOOOOOOOOOOOOOOOOOOOOOXXOOOOOOXXOOXOOOOOOOOOOOOO
OXOOOOOOOOOXOOOOOOOOOOOOOXXOOXXOOOOOOOOOOOOXOOXOOOOOOXXOOOOOXOOOOOOOOOOOXOOOOXXOOOOOOOOXOOXXOXOOOOXX
OXOOOOOOOOOOOXXOOOOXOOOOOXOXOOOOXXOOOOOOOOOXOOOOOOOOOOOXOOOOOOOOOOOOOOOXXOOXOOXOOOOOOOOOOOXOOXXXOOOO
OOOOXOOOOOOOOOXXOOXOOXOOOOXOXOOOXOOXOOOOOXXOXOOOOOOOOOOXOXOOXXXOOOOOOOOOOOOOOOOOOOOOXXOOOOOOOOOOOOOX
OOOXOOXOOXOOXOOOXOOOXOOOOOOOOOOOOXXXOXOOXOOOOOOXXOOOOOOOXOOOOOXOXOOOOOOOOOXOOOXOOOOXOOOOOOOOXOOOOXXO
OOOOOOOOOOXOOOOOOOOOXOXOOOOOXOOOOXOOOOOOOOXOXOOOXOOOOOOOXXOXOOOOOOOXOOOOOOOXOOOOOXOOOOOOOOOXOOOXOXXO
XOXOOOOOOOXOOOOOOOOXOOOOXXOOOXXOOOOOOOXOXOOOXOOOOOOOOOXXOOOOOOOOOOXOOOXOOXOOOOOOOOXOOOOOOOOOXXOOOOOO
OXOOOOOOOOXOXXOOOOOOXXOOXXOOOOOOOOOXOOOOOOOOOOXOOOXOOOOXXXXOXOOOXXOXOXOXXOOXOXXOOOOOOOOOOOOOXOXOOOOO
OOOOXOOOOXOOOOOXOOOOOOOOOXOXOOOOOOOXOOOXOOOXXXOOOOOOOOXOOOOOOOOOOOOOOXOOOOOOOOOOOOOOOXXOOXXOXOXOOOOO
OOOOXOXOOXOOOOOOOOOOXOXOOOOOOOOOOFOXOOOXOXXOOOOOOOXXOOOOOOOOOOXOXXOOOOOOOOOOOOXOXOOOXOOXOXOOXOOOOOOO
OXOOOOOOOOOOOXOOOXOOOXXOOXOOOOXOOOOOXOXOOOOXOXOOXOOOOOOOOOOOOOOOOOOXOOOOXXOXOOXXXOOOOOOOOOOOXOOOOOOX
OOOXOOOOOOXOOOOOOOOOOOOOOOXOOOOOXOOOOXOOXOOOOOXOOOOOOXOOOOOOOOXOOOXOOXXOXOOXOOOOOOOOXOOXOOOOOXXOOXXO
OOOOOOOOOOOOOOOOXOOOXOOOOOOOOOOOXOXOOOOOOOOOOOOOOXOOOOXOOOXOXOOOXOXOOOOOOOOOOOOOOOOXOOOOOOOOOOXXOOOO
OOOOOOOOOOOOOOOOOOXOOOOOOOOXOOOOXOOOXOOOOOOOOXOOXOOXOOOOXOOOOOOOOXXOOOOOOOXOOOXOXOOOOOOOXOXOOXOOOOOX
OXOOXOXOOOOXOOOOOOXXOOOOXOOOXOOXOXOXOXOOOXOXOOOOXXOOXOOOOXOOOXXOOOOOXOOOOXOOOOOOOOOOXOOOXOOOOXOOOXXX
OOOOXOOXOOOOOOOOXOOOXOOXXOOOOOOXOOOOOOOOOOOOOOOOOXXOOOOOXOXOOOXOXOOOOOOOXXOOOOOXOOXOOXOOOOOOOOOOOOOO
OOXOOXOXOOOOOOXOOOOOOOOOOOOOOOOOXOOOOOOOOXXOOOXXOOOOOOOOOOOOOOOOOOOOOOOOOXOOXOOOXOOOOOXOOOOOOXOOOOOO
OXOOXXOOOOXXXOOOOOXXOOOXOOOOOOOOOOOOOOOOOOOOOOOOOOOOOOOOOOOOOXXOXOOOOOOOXOXOOOOOOOXOOXOOOXOXOOXOXOOO
OOOXOOOOOXOOOOOOOOXOOOOOOOOOOOOOXOOOOOOOOOOOXOXOOOOOOOOOOOXOOOOOXOOOOOOOXOOOOOOOOOOOOXOOXOOOOOOOOOOO
OOOXOOOOOOOOOOOOOOOOOOOOXXXOOOOXOOOOOOOOOOOOXOOXOOOOOOOOXOOOOXXOOOOOOOOOOOXOOOOOOXOOOOXOOOXXXOOOOOOO
XOOOOOOOOOXOOOOOXOOOOOOOOOOOOOOOXOOOXOOXOOOXOOOOOOXOOOOOOOOXOOOOOXXOXOOXOOXOOXXOOXOOOOOOOOOOXXOOOOOO
XOXOOOOOOXOOOOXOXOXOXXOOOXOXOOXOOOOOOOOOOOOOOOOOOOOOOXOXOOOOOOOOOOOOOOOXXOOXOOOOOOOXOOOOOOXOOOOOOOXO
OXXOXOOOOOOXOOOXXOOOOOOOOXOOOOOOOOOOOOOOOOXXOOOOOOOOOXOOOOOXOOOOOOOOXOOOOXOOOOOOOXOOOOXOOOOOOXXOOOOO
XOOOOOOOOOOOOOOXOOOOOOOOOXXOOOOOOOXOOXOOOOXOOOOOOOXOOOOOXXOOOOOOOXOXXOOOOOOOOXOOOOOXXOOXOXOOOOXOOOXO
XOOOOOOOOOOOOXOOOOOOOOOOOOOOOOXOXOOOOOOOOOXOOOXXOXXOXOOOOOXOXOXOOOOXXOOOOOOOOOOOOOOOOOOOOOXOOOOOOOXO
OOOOXOXOOOOOOOOOOOOOOXXOXOOOXOOOXOOOOOOOOOOOOOXOOOOOOOOOOOOXOOOOOOOOOOXOXOOOOOOOOOXOOOOOOOOOOOOOOXOO
XOOOOXOOOXOOOOOOXOOOOOXOXOOXOXXOOOOOXOOOOOOOOOXOXXOOOOXOXOOOOOOOXOOOXOOOXXOOOOOOXOOOOOXOOOXOOXOOOOXO
OOOOOOXXOOOXOOXOOOOOOOOOXXOOOOOOOOXXOOOOOOOOOOOOOOOOOOOOOOOOOOOXOOXOXOOOXOOXOOOOOOOOOOOOOOXOOOOOOOOO
XXOOOOOOOOOXXOOOOOOOOOOOOOOOOOXOOXOXOXOOOOOXOOOOOOOOXOOOOOOOXOOOOXOOOOOXOOOOOXOOOXOXOOOOXOOXOXOOXOOO
OXOOOOOOOOXOOOOOOOOOOOOOOXOOXOOXOXXOOOOOOOOOOOOOOXOOOXOOXOOOOOXOOOOXOOOOOOOOOOOOOOOXOXOOOXOOOOXOOOOX
OOOOOXOOOXOOOOOOOOOOOXXOOOOOXXOOOXOXOOOOXOOOXOOOOOOOOOXOXOOOXOOOOOXOOXOOOOOOOOOXOOXOOOOOOOOOOOOOOOOO
OOOOOOOXXOOOOXXOOOOOOOOOOOOXOOOOOXXOOOOOOOOOOOOOXOOXOXOOOOOOOOOOOOXOOOOOOOOXOXOOXOOOOOOOOOOOOOOOOOOO
XOXOOXOXXOOOOXOOOOOOOOOOOOOOOOOOOOOOOOOOOOOOXOOOOOOOOOOOOOOOOXOXOOXOOOOOOOOOOXXOOOOXOOOOOOOOOOOXOXXO
OXOXOXXOOOOOOOOXOOOXXOOOOOOOOXOXOOOOXXOXOOOXOXOOOOOOOOOXXOOOOXOOOXXOOOXOOOXXOXXOOXOOOOOOOOOOOOOOOOOO
OOXOXOXOOOOOOOXOOXXOOOOOXOOXOOOOOOOXOOOXXOXXOOOOOOOOOXXOXOOOOOOOOOOOOOOOOOOXOOOOXXOOOOOOOXXOOOOOXOXO
XOOOOXOXOOXXOOOXOOOOXOOOOOXOOXXOXOOOXOOXOOOXOOOOOOXOOXOXOOOOOXOOOOOOOXOOXOOOXXOOOOOOOOOOXOOOXOOOOOOX
XOXOXOOOOOOOOOOOOXOOOOOXOXOOOOOOXOOOOOOOOOXOOOOOOOOOOOOOOOXOOOOOOOOOOOOOOOOXXOOOOXOOXXOXXOXOOOOOOOOO
OOXXOOOOOXXOXOOOXXOOXOXOOOOOOOOOOOXOOOOOOXOOXOOOXXOOOOOOOXOOOOOOXOOOOOOOOXOOOXOXOOOOOOXOXOOOOXXOXOXX
OOOXXXOOXOOOOOOOOOXOOXOOXOOXOOOXOXOOOXOOOOXOOOOOXOOOOOXOOXOOOOOOOOOOOOOOOOOXXOOOOOOXOXOOOOOOOOXXOOOX
OOOXOOOOOOOOOXOOOXXOOOXOOOOOOOXOOOOOOOOOOXXOOOXOXOXOOOOOOOOOOOOXXOOOOOOXOXXOOOOOOOOOOOXXOXXOOOOOOOOO
OOOOOOXOOOOXOOOXOOXOOOOOOOOXXOOOOOOOOOOXOOOOOOOOOOOXOOOOOOOOXXOOOOOOOOOXXOOOOOOOOXOOOOOOOXOXXOOXOOOO
OOOOOXOXOOOOOXOOOOOOOOOOOOOOOOOOOOXOOOOOXOOOOOOOXOOOOOOOOXXOOOXOOOXOOOOOOOOOOOOOOOOXOOOXOOOOXOOOOXOX
OOOOOOOXOXOOOOOXOOOOOXOOXOXOOOOOOOOOOXOOOOXOXOOOOOXXOOOXOOOOOOOOOXOOOOOXOOXOOOXOOOOOOXOOXOOOOOOOOOOO
OOOOOOOOOOXOXXOOOOOOOOOOXOOOOOOOOXOOXOOOOOOOOOOOOOOOOXOOOOOOOOOOOOOOOOOOOXOOXOOOOOOOOXOOXOOOOXOOOOOX
OOOXXOOOOXOOOOXOOOOOOOOOOOOOXOOXXOOOOOXOOOOOOOOOOOOOOXXOOXOOXOOOXOXXOOOOOXOOXOXOOOOOXOOXOXOOOOOOOOXO
