OOOOXXOOOOOOXOO
OOOOOOOXOOXXOOO
OOOOOOXOOOOXXOO
OOOOOXOOXOOOOOO
XOXOOOOOXOOOOOO
OOOXOXOOXOOOXOX
OXOOOOOXOOOOOOO
OOOOOFOOXOOOOO*
OOXOOOXOOOOOOOO
OOXXOOOOOOOXOXO
OOOOOOXOOOXXOOO
OOOOXOOOOOOOXOO
OOOOOXOOOXOXXOX
OOOOOOOOOOOOOOO
OXOOOXOOOOOOOOO
