OOOOOXOOXXOOOOOOOOOOOOOOOOOXOOOOOOOOOOOOOOOOOOXOOOOOOOOOXOOOOXOOOXOOOOOOXOXOXOOXOXXOOOOXOXOOOOOOOXOO
OXOOOOOOOOOOOOXOXOXOOOOOXOOOOOOOOOXOOOOOOOOOOOXOOOOOOOOOOOOOOXXOXXOOOXOXOOOOOOOOOXOXOOOOOOOOOXOOOOOO
OOOOOOXXOOXOOXOOOOOOXXOOOOOOXOOOOOOOXOOOOOOOOOOXXOOOOOOOOOOOXOOOOOOXOOOOOOXOOXOOOXOOOOXOXXOOOOXXXOOO
OOOOOOOXOOOXOOOOOXOOOXXXOOOOXOXOOOOOXOOXOOOOOOOOXOOOOXOOOOOOOXXOOOOOOOOOOOXOOOOOOOOOXOOOOOOOXXOOOOOO
OOOOOOOOOOOOOOOXOOOOOOOOXOOOOOOOOOOOOOOOOXOOOOOOOOXOXOOOOOOOOXOOXOOOOOOOOOOOOOOOOOOOOXOOOOOOOOOOXOOO
OOOOOXOOOOOXXOXOOOXXOOXXOOOOOOOOOOXOOXOOOOOOXOXOXOOOOOXOOOOOXOOXOOOOOOOOOOOOXOOOXOOOOXOXOOOOOOOXOXOO
OOOOOOO*OOOOOOOOOXOOOOOOXOXOXOOOOXOOOOOOXOXOOOOOOOOOOOOOOOOOOOOOXOXOOOOOOOOXXOOOOOOOOOOOOOXOOXOOOOOO
OOOOOOOOOOXOOOOOOOXOOOOOOOOOOOXOOXOXOOOXXOOOOOOOOXOOOXOOOOOOOOOOOOOOOOXOOXOXOOOOOOOOOXOOOOOOOOOOOOOO
OOOXOOOOOOOOXXOOXOXOXOOOOOOOOXOXOOOOOOOOXOXOOOOOOXXOOOOOOOXOOOXOOOOOXOXXOOOOOOOOOOOXOOOOOOXOOOOOXOOO
XOXOOXOOOOOOOOOOOOOOOOXXOXOOOOOXOXOOXOOOOOOOXXXOXOXXOXXOXOXOOOXOOXOXOXXOOOOOOOOOOOOOOOOOOXOXOOOOOOOO
OOOOOOOXOOXOOXOXOOOOOOOOOOXOOXOXOOOOOOOOXXOOOOOOOXOOOOXOOOOOOXOOOXOXOOOOOOOOOOOOOOOXOXOOOOOOOOOOOOXO
OOOOOXOOOOOOXOOXOOOXOOOOOXOOXOOXOOOOOOOOOXXOOOOXOXOOOOOOXOOOOOOOOOXOOOXOOXOXXOOOOOOOXOOOOOOOOOOXOOOO
OOOOOOOOOOXOOOOOOOOOOOOOOXOOOOOOOXOOOOOOOOOOOXOOOOOXXOOOXXOOXOOOOOOOXOOOOOOOOXOOOXOXOOXXOXXXOOOOOOXO
XOOXOOXOOXOOOXOXOOOOOXXOOOXOOXOOOOXOOOOOOOOOOOOOOOOOOOXOXOXXOXOOOXXXOOOXOOOOOOOOOOOOOOOOOOOOOOOOOXXO
OXOOOXOOOOOOXOOOXOOOOOOOOXXXOOOOOOOOOOOOOOXOOOOOOXOOOOOXOOOOOOOOOOOOOXOOOOOOXOXOOOOOOOXOOOOOOOXOOOOO
OOOOOOOOOOOXOOXOOOXOOOOXOOOOOOOOOOOOOOOXOOOXOOOOOOOOOOOXOOOOOOOOOOXOOOXOOOOOOOOOOOOOOOOOXOOXOOOOXOOO
OOOXXOOOOXXOOOOOXOOOXXOOOOOOOOOOXOOXOOOXOOOOOOOOOXOOOOOOOOOXOOOOOOOOOOOOXOOXOXOOOOOOOOOOOOXOOOOXOOOO
XOXOOOOOOOOOOOXXOOOOXOXOOOXOOOOOOXXOOOXOOOOXOXOOXOOOOOOOOOXOXOOOXOOXOXOOOOXOOXXOOXOXOOOXOXOOOXOOXOXO
OOOOOOOOOOOOOOOOOOOOOOOOOOOOOOOOOOOXXOOOOXOOOOOOOOOOOOXOOOOOXOOOOOOOOXXOXXOOOOOXOXOOOXOOOOOXXXOXOOOO
OOXXOOOOOOOOOOXOOOXXOOOOOOOOOOOXOOOOOOOOOOOOOXOXXOOOOXOOXOOOOOOXOOOXOOXOOOOOOOXOOOOOOOOXOOOOOOOOOXOX
OOOOOOOOOOOOOOOOOOXOOOXOOOXOOOOOOOOXXOOOOXOOOOOOOXOOOOOOOOOOOOOXXOOOOOOOOOOOOXOOOOOOXXOOXOOOOOOOOXOO
OOOOOXOXOXOOOOOOOOOXOOOOOOOOXOOOOOXOOOOOOOOOOOOOXOOOOXOOXOXOXOOXXOOOOOOOOOXOXOOXOXXOOOXOOOOOOOOOOXOO
OXXXOOXXOOOOOXOOXOXOOOOOXOXOOOXOOXOXOOOXOOOOOXOOOOOOOOOOXOOXXOOOXOXOOOOXOOOOOOOOOOOOXXOOOOOOXXXOOOOO
OOOOOOOOOOOXOOOOOXOOOXOOOOOXOOOOOXOOOOOOOOXOOOOOOOOOOOOOOOOOOOOXOOOOOOOOOOOOOOOOOOOOOOOOOXOOOOOXOOOO
OOOOOOOOOOOOOOOOOXOXOOXXOOOOXOOXXXXOOOOOXOOOOOOXOOOXOOOOOOOOXOOOXXOOOOXOOOOOOOOOOOOOOXXXOOOOXOOXXOXO
OOOOOXOOOOOOOOOOOOXOOOOOXOOOXOOOOOOOOOOOOOOOOXOXOOOOXOOOXOOOOOOOOOXOOOOOOOOOOOOOOOOOOOOOOXOOOOOOOOOX
OXOOXOOOOOOXXOOXOOOOOOOOOOOOOOOOOOXOXOOXOOOOOOOXXOXXOOOOXOOOOOOOOOOOOOOOOOOOOXOOOOOXOXOOOOOOOOOOOOOO
OXOOXOOOOOOOXOOOOXOOXXOXOOOXOOOXOOOXXOOOOOOXOXOOXXOOOOOOXOOOOOXOXOOOOXOOOOOOOOOXOOOOOOOOOOOOOOOOOOOO
OXOOOOOOOOOOOXOOOOOOOOOOXXOOOOOOOOOXOOOXOOOOOOOOOOXOOOOOOOOXOOOXOOOOXOOOOOOXXOOOOOOOXOXOXOOOOOXOOOOO
OOOOOOOOXOOOOXXOOOOOOOOOOOXOXOOOOOOOOOXOOOOOOOOOOOXXOOOOOOOOOXOOXOXOXOOOXOXOXOOOXXXOOOXOXOOOOXOOOOOO
OXOOXXOOOXOOXXOOXXOOOOOOOOOOOOOOOOOOXXOOOOOOOOOOXOOXXXOOOXOOOOOOOOXOXOOOOOOOOOOOOXOOOOOXOOXOOOOOOOXO
OXOOOOXOXOOOOOOOOOOOOOOOOOOOOOOOOOOOXOOXOXOOXOOOOOOOXOOOOOOOOOOOOOOOOOOOOOOOOOOOOOOOOOOXOOOOOXOXOOXO
OOOOOXOXXOOOXOXOOXOXOOOOOOOXXOXOOOOOOOOOOOOOOOOOOOOOOOOOOOXOOXOOOOOOOOOOOOOOOOOXOOXOOOOOOOOOXOOOXOOO
OOOOXOXOOOOOOOOXOOOOOOOOXXOOOOOOOOOOOOOOXXOOXOOOXXOOOOXOOOXOOOOXXOOOXXOXOOXOOOOOOOXOXOXOOOOOOOOXOXOO
OOOXOOOXOOOOOXXOXOOOOXOOOXOOXOOOXOOOOXOXOOOXXOOOOOOOXOOOOOOOOOXOOOXOOOOXXOOOOOOOXOOOOOOOOOOOOOOOOOOO
OXOOOOOOOOOOOXOOOOOOOOOXXXOOOXOOOOOOOOOXXXOOOOOOOOOOOOOOOOOOOOOOOOXOXOOXOXOOOOXOOOOOOOXOXOOOXOOOOOOO
OOOOOOOOOOOXOOOXOXXXOXOXOOOOOOOXOXOXOOXOXOOOOOOXOOOOXOOOXXOOOOXOOOOOOOOOXOXOOOOOOOOOOOOOOOOOOOOOOOXX
XOXOOOOOOOOOOOOOOOOOOOOOOOOOOOOOXOOXOOOOOOOOXOOXOOOXXOOOXOOOOXOOOOOOOOOOOXOOOXOXXOOXOOXOOXOOOOXXOOOO
OOOOOOOOXOOOXXOOOOOOOOOOXOOXOOOXXOOOOXOXOOOOOOXOOXOOXXXOOOOOOOOOOXOOXXOOOOOOXOOXOOOOOXOOOOXOOOXOOOOX
OOOOOOOOOOOOOOOOXXOOOOOOOOOOXOOOOOOXOOOXOOOOOOOOOOOOOOOOXXXXOXXOOOXXXOOOOOOOOOOXOOOOOOOOOOOOXOOOOOOO
OOOXXOOOOOOOOXOOOOOOOOOXXOOOOOOOOOOXOOOOOOOXOOOXXOOOOOOOOXOXOOOOOXOOOOOOOOOOOOOOXXOOOOOOOXFXOOOOXOOO
OOOOOOOXOOOOOOOOOOOXXOOOOOXOOOXXOXOOOOOOOOOOOOOOOXOOOOOOOOOXOOOOOOOOOOXXXOXOOOOXXOOOOOOOOOOOOOOXOXOX
OOOOOOOXOOOOOXOOOOXOXOOOOOOOXOOOXOXXOXOOOXOOOOOOOOOXXOOOOOOOOOOOOOOXOOOOOOOOOOXOOOOOOOOOOOOOXOOXXXOX
OOOOXOOOXOOOOOOOOOXOOOXOOOOXOOOOOOOOOOOOOXOOOOOOOOOOXOOXXOXOXOOXOOOOOXOOOOXOOOOOXXOOOOOOXXOOOOOOOOOO
OXOOOOOXXOOOOXXOOOOOOOOOXOOOXOOOOOOOOOOOOOXOOOOOOXOOOOOOOOOOOOOOXOOOOOOOOOOOOOXOXOOOOOOXOOOOOXOOOOOO
OXOOOOXOOOOOOXXOOOOOXOOOOOOOXOOOOOOOOOXXXOOOXOOOOOOOOOXOXOOOOXXOOOXOXOOOOOOOOOOOXOXXOOOOOOOOOOXOOOXO
OOOOOOOOOXOOXOOOXXOOOOOOOOOOXOOOXOXOOXOOOOXXXOOXOXOOOOXOOOXOOXXOOXXOOOOOOXOOOOOOOOXXOOXXOOOOXOOOXOOX
OXOOOOOOOOXOOOOXOOOOOOOXOXOOOOOOOOOOXOXOOOOXOOOOOXOXOOOOOOXOOOOOOXOXOOXOOOOOOOOXOOOOOOOOOOOOOOOOOOOO
OOXOOOOXOXXOOOXXOOOXOOXOOOOXOXOOOOOOXOOOOOOXOOOOOOOOOOOOXOOOOXOOOXOXOOOXOOOOOXOOOXXXXOOOOOOOOXOOOOOO
OOXOXOOOOOOXOOOOOOOXOXOOXOOOOXOOOOOOOXOOOOXOOOOOOOXOOOOOOOOOOOOXOXOXXOOOOOOOOOOOOOOOOXOOOOOOOOOOOOOO
OOOOOOXOOOOOOOOXOOOXOOXXOOXOOOOXXOOXOXOOOOOOOOOOOOXOOOOXOOOOXOOOOXXOOXOOOXOXOOOOXOOOXOOOOOOOXOOXXOOO
OOOOOOOOXOOOOOXOXOOOOOOOOOOOOOOXOOOOOOOOOOOOOOOOXOOOOOOOXOOOOXOOXOOOOOOOOXOOOOOOXOOOOOXOOOOOOXXXOXOO
OOOOOOXOOOOXOOOOOXOOOOOXOOXOOOOOOOXOOOOOXOOOOXOXOOOOOOOOOOXXOOOOXXOOOOOXXXOOOOOOOOOOXOOOOOOOOOXOOOXX
OOOOOOOXOOXOOOXOOOOOOOOOOOOOOXXOOOOOOOOOOOOOXOOOOXOXXOXXOOXOOOOOOOOOOOOOOOOOOXOXXOOOOOOOXOOOOOXOOOOX
XOOOXXXOOOOOOOOXOOOOOOOOOOOOXOOOOXOXOOOOOOXOOOOOXOOOOXXOOOOOOOOOOOOOOOOOOOXOOOOOOOOOOOOOOOOXXOOOOOOO
OOXXOXOOOOOXXOOOOOOOOOOOOOOOOOOOOOXOOOOOOOOXXOXOOOOOOOOXOOOOOOOOOOOXOOOOOOOOOOOOOOXOOOOOOOOOOXOOOOXO
XOOOOOOOOOOOXOXOOOOOOXOOOOOOOOOOOXOOOOOOOXOOOXXOOOOOOOOXOOOOOXOOOXOOOOOXOOOOOOXOOOOOOXOOOXXOOOOOOOOX
OOOOOOOXXOOOXOOOOOOOOOXOOOOOXOOOOOOXXOXOOOOOOOXOOXXXOOOXOXOOXOOOOOOOOOOOXOXXOOXOOXOOOOOOXXOOOOOOOOOO
XOOOOOOOOXOOOOOOOOOOOXOOOOXOOXOOOOOOOOOOOOOOXOOOOOXOOXOOOOXOOOOOXXXOOOOXOXOOOOXOXOOXOOXOOOOOOXOXOXOO
XOOOOOOOOOOOXOOOOOXOOOOOOOOOOOOOOXOOOOOOXOOOXOOOOOOOOOOOOOOOOOOOOXOOOOOOXXOOOOOOOOOOOOOXXOOOOXXOOOXO
XXOOOOOOOXOOOOOOOOOOOOOOXXOXXOOXXOXOOOOOOOOOOOXOOOOOOOOXXOOOOOXOOOOOOOOOOOOOOXOXOOOOOXXOOOOXOXOOOOOO
OOOOOOOOOOOOOOOXOXOOOOOOXOXOOOXOOOOXOOOOOXXOOOOOXOOOOOOOOXXOXOXOOXOOXOOOOOOOOOOOOOOOXOOOOOOOOOXOOOOO
OOOXOOOXOOOOOXOXXOOOOOXOOOXOOOOOOOOOXOXXOOOOXOOOOOOOOOOOOXOOOXOOXOOOOOOOOOOOOOOXOOOOXOOOOOOXOOXOOXOO
OOOOOOOOOOOOOOOOXXOOOOXOXOOOXOXOOXOOXOOXXOOOXOOOOXXOOXOOOOXOOXOOXOOOOOXXOXXOOXOOOXOOOOXOOOXOOOOXOXOO
XOOOOOOOOXOOOOXOOOXOOOOXOOOOOOOOOOOOXXOOOXOOXXOOXOOOOXOOOXOXOOOOXOOOXOOOOOOOOOOOOOOOOOXOOOOOOOOXOOOO
OOOOXXOOOOOOOOOOOOOOOXOOOOOOOOOOOOOXXOOXXOXOOOOOOOOOOOOOOOXXOXOOOOXOOOOXOOOOXOOOOOXOOOOOOOOOOOOOOOOO
OXOOOXOOOOOOOOOOOOOOOOOOOOOOOOOOOOOOOOOOOOXOOOXOXOOOOXOOOOOXOOOXXOXOOXOOOOOOOOXOOXXOOOXOOXOOOOOOOOOO
OXOXOOOOXOOOOOOOOOOOOOOOXOOOOOOOXXOOOOOOOOXOXOOOOOOXXXOXOOXOOOOOOOOOOOOOOOOOOOOOOOXXOOOOXOOXOOOOOXOO
OOOOOOOOOOOOOXOOOOOOXOOOOOXOOOOOOXXOOOOOXOOXOOXXOXOOOOOOXOXOOXXOXOOOOOOOXOXOOXOOXOOOOOOOOOOOOOXOXOOX
XXOOXOOOOOOOOOOOOOOOOOOOXOOOOOOOOOOOXXOOOOOOOOOOOOOXOOOOOOXXOOOOOXOOXOOOXOOOXOOOOOOOOOOXOXOXOXOOOOOO
OXOOOOOOXXOOOOOOOOOOOOOOOOOOOOXOOOOOOXXOXOOOOOOOOOOOOOOOOOXOOOOOOOOXOOOOOOOOOOOXOOOOXOOOOOOOOOOXOOOO
OOOOOOOOXOOOOOOOXOXOXOOOOOOOOOOOOOOOOOOOXOXOOOXOOXOOXOOOOXOOXOOOOXOOOOOOOOXOXXXOXXOXOXOOOOOOOOOOOOOO
OOOOXOOOOOOOOOXXOOOOOXOOOOOOOOXOXOOOOOOOOOOOXOXOOOOOOOOOOOOOOXOXOXXXOOOOOOOXOOOOOOOOOXOOOXOOOOOOOOOO
OXOOOOOOOOOOOOOOOOXOOOXOOXOOOOOOOXOOOXXXXOXOOOOOXOOOOOOXOOOOOOOXOXOOOXOOOOOOOOOOOOOOOOOOOOXOOOXOOOOO
OOOOOOOOOXXOOOXXXOOOOOOOXOOOOOOOOOOOOOOOOOXOOXOOOXXOOOOXOOOOOOOOXXOOOXOOOOOOXOOOOOXOXOOOOOOOOXOOOOXO
OOOXOOOOOOOOOXOOOXOOOXOXOOOOOXOOOOOOOOOXXXOOOOOOOOOXOOOOOOOXOOXOOOOOOXOOOOOOOOOOOOOOOXOOXOOOOXOOOOOO
OOOOOOOOOOOOOXOOOXOOOOOOOXOXXOOOOOOOOXOOOOOOOOXOOOXOOXOOOOOXOOOXOOOOXOOOOOOOXOOXOOXOOOOXOXOOOOOOOXOO
OXOOOOOOXOOXOOOOOOOOOXOOOXOOXOXOOXOOXOOOXOOOOOOOXOOOOOOXOOOOOOOOOOOOXOOOOXOOOOOOXOOOOOOOOOOOOOOOOXOX
XOOOOOOXOOOOOOOOXXOOOOOOOOOOOOOOOOXOOOOXOOOOOOOOOOOOOXXOOOOXOOOOOXOOOOOOOOOOXOXOOOOXOXXOXOOXOOOXOOXO
OOOOXXOOOOOOXXOOXOOOOOOOOOOOOOOOOOOOOXOOOOOOOXOOOXOXOOOOOOOOOOOOOOXOOOOXXOOOOOOOOOXOOOOOXOOOOOOXXXOO
OOXOOOOOOOOOOOOXOOOOOOOOOOXOXOOOOOOOOOXXOOOOOXOOOXOXOOOOXOOOOOOOXXOOOOOOXOOOOOOXOOOOOOOOOOOOOOOXOOOO
OOXOOXOOOOOOOOOOOOXOOOOOOOXXOOOOOXXOOXOOOXOOOOOOOOOXOOOOXXOOXOOOOXOOOXOXOOOOOOOXOXOOOXOOOXOOOOOOXOOO
OXOXOOOOOOOOXOXOXXOXOOOOOOXOOOOOXOOOOOOXXOOOOOOOOOOOOOXOXXOXOOOOOOOOOOOOOOOXOOXXXOOOXOOOOOXOOOOOOOOO
OOOOXOOOOOOOOOOOOXOOOOOOOOXOOOXOXOOOOOXOOOOOOOXOOOOXOOOXOOXXOOXOOOOOOOOXOOOOOOXOOOOOOXOOOOOXXOOOOOXO
OOOOOOOXXOOXOXOOOOXOOOOXOXOOOOOOOOOOXOOOOOOOOOXOXOXOOOXOOOOXOXOXOOOOOOXOOOOOOOOOOOOXXOOOXOOOOOXOOOOO
OOOOOOOOOOOOXXOOOOOOOOOXOOOOXOOXXOOOOOOXOOOOOXOOOOOXOOOOOOOOOOOOOOXOOOOOOOOXOOXOXOXXXOOOOOOOOXOOOOOO
OOXOOOOOOXOXXOOOXOOOXXOOXOOOOXOOXOOOOOOOXOOOOXOOXOOXOXXOXOOOOOOOOOOOOOOXOOOOOOOOXXOOOOXOOOOOXOOOXOOX
OOOXXOOOOOOOOOOOOXOOOOOOOOOOOOOXXOOXXOOOOOOOOOOOOOXXOOOOOOOXOOOOXOOOXOXOOOOXXOOXOOOOOOXOOOOOOOOOXXOO
OOXOOOOOXOOOOXOOOXOOOOOOOXOOOXOOXXOOOOXOOOOOOOOOOOOOOXXOXXOOOOOXOOOOOOOOOOOXOOOOOOOOOOOOOXOOOOXOOOOO
OXXOOOXOOOOOOXXOOXXOOOOOOOOOXOXOOOOOOOOOOOOOOOOOOOOOOOOOOOXXOOXOOOOXOOOXOOOXOOOXOOOOOOOXOOOOOOOOOOOO
OOOOOOOOOOOXOOOOOXOOOXOOOOOOOOXOOOXOOOOOOOOOOOXOOOOOOOOOOOOOOOOOXXOOXOXOOXXOOOOXXOOOOOOOOOXOOXOOOOOX
OOXOXOOXOOOOOOXOOOOOOOOOXOOOOOXOOOOOOXOOOOXOOOXOXOOOXOOXOOOOOOOOXOXOOOOOOOOOOOOOOXOOOOOOXOOOOOXOXOOO
XOOOOOOXOOOOOOOOOOOOOOOOXOOOXOOOOOOOOXOOOXXOOOOOOXOXOOOOOOOXOOOOOOOOXOOOXOOOOOOOOOOXXOOOOXOOOOXOOOXO
XOXOOOXOOOXOXOOOOOOOXXOOOXXOOOOXXOOOOOOOOXOOOXXOOOOXOOOOOOOOXXOOXXOOOOOOOOOXOOOOXXOOXOOOOOOOOOOOXOOO
OOOOOOOXOOOOOXXOOOOOOOOOOOOOOXOOXOXOOXOOOOOOOOXXOOOXOOOXOOOOOOOOXOOOXOOXOXOOOOOOOOXXXOOOOOOOOOOOOXOO
OXOOXOOOOOOOOXOOOOOOXOOOXOOXOOOXOOOXOOXOXOOOOOOOXOOOOXOOOOOOOOOOOOXOOOOOOOOXXOXOOOOOOOOXOOOOOXOOOXOO
OOOOOOOOOOXOOXOOOOOOXXXOOOOOOOOOOXOOOXOXXOXOOOOOOOOOXOOOOOOOOOOOXOXOOOOOOOOOOOOXOXOOOOXOOOOOOOOOOOOX
OOOOOOOOOOXOOXOOOOOOOOOOOOOOXOOXOXOOOOOOOOOOXOOOOOOOOXOOOOOOOOOXOOOOOOXOXOOXXXOXOOOOOOOOOOOOOOOOOXXO
OOOOOOOXOOOOOOOOOOOOOOOOOXOOOOOOOOXOOOOOOOOOOOOOXOOOOOOXOXXOOOOOOOOOOOOOOOOOOOOOXOOOXOXOOOXOOXOOOOOX
OXOOXXOXOXOOXXOXOOXOOOOXXOOOOXXXOOOOOOOOOOOXOOXOOOOOOXOOOOXOOOOOOXOOOOOOOXOXXOOOOXOOOOOOOOOOOOOOOOOO
