OOOOOOOOOXOOOOOOOOOOOOXOOOXOOOOOOXOOOXOOOOOOXOXXXOOOOOOOOOOOXXXOOOOOOOOOOOOOOOXOOOOXOOOOOOXOOOOOOOOX
XXOOOOXOOOXOXOXXOOOXXOXOOOOOXOOOOOXOOXOOXOOOOOOOOOOOOOOOOOOOXOOOOOOOOOOOOOOOOOXOOOOOOOOOOOOOOOOOXOXO
OOOOOOOOOOXOOOOOOOOOOXOOOXOOOOXXOOOOOOOOOXOOOOOOOOOOOOOOOOOOOXOOOOOOXXOOXOOOOOOOOOOOOXXOOOXXOOOOOOOO
OXXOOOOXOOOOOOXOOOOOOOXOOOOOOOOXOXXOOOOOOXXOOOOOOOXOOOOOOOOOXOOOOOOOOXOXOOOOOOOOOXOOOOXOOOOOOOOOOOOX
OOOOXOXOOOOXOXOOXOOOOXOOOOXOOXOOOOOXOOXOOOXOXXOOOOOOOOOOOOXOOOOOOOXOOXXXOOXOOOXOOOOOOOOXOOOOOOOOXOOO
OOOOOOXOOXOOXOOOOXXOXOOOOOXXOOOXXXOOOOOXXOOOXXXXOOOOOOOOOOXXXOOOOOOOOOOOOXXXOOOOOXOOOOXOXOOXOOXOOOOO
OOOOOOOXOOOOOXOOOOOOOOXOOXOXOOXOOXOOOOOOXOOOOXOXOOOOOOXOOOOOOXOXOOOOOXOOOOXOOOOOOOOOXOOOOOOOOOOXOOOO
OOOOXOXOOOOXOXOOOOOOXOOOOOOOOOOOOOXOXOOOOOOXOOXOXXOOXOXXOOOOXOOOXOOOXOOOOOOXOXOOXOOXOOOOOXOOOOOOOOOO
OOOXOOOXOOOOOOXOOOOOXOOXOOOOOOOOOOOOOOOOOOOXOOOOOOOOXOOXOOXOOOOXOOOOOOOOOOOOOOOOXOOOOOOOOOOOOOOOOOOO
OOOOXOOOOOXOOOOOXOXOOXOOOXOOOOOOOOOOOXXOOOOOOXOOOOOOOOOOOOXOOOOXXOOOOOOXOOOOOXOOXOOOOOOOOXXOOOXOOOXO
OOOOOOOOOOXOOOOOOOXXOXOXXOOXOOOOOOOOOXOOOOOOOOOXOOOOOOOOOOOOXOXOXOXOXOOXXOOOOOOOOXXOOXOOOXOOOOOOOXOO
XXXOOOOOOOXOOOOXXOXXOXOOOOOXXOOOOOOOOOOXOOOXOXOOOOXOOOOOOOOOOOOXOOOOOOOOXOOOOOXOOOOOOXOOOXOOOOOOXOOO
OOOOOXXOOOXOOXOOOOOOOOOOOOOOOXXOOOOXXXOOXOOOOOOOXOOOXOOOOXOOOOXOOOOOOOOOOOXOOOOXOXOOXOOOXXOXOOOOXXOO
OOXOOOXOXOOOOOOXXOOOOOOOOOOOOOXOXOOOOOOOOOOXOOOOOOOOOXOOOOOOOXOOXOOOOOOOXOOOOOOOOOOOOXXXOOXOXXOOXOOX
OOOOOOOOOOOOOOOOOOOOOOOOXOOOOOOOOOOXOOOOOOOOOXOOOOOOOOOOOOOOOOOOOOOOXXOXOOOOOOOOOXOOOOXOOOOOOOXOXOOO
OOOOOOOXOOXOOOOOXOOOOXOOOOOOOOOOOOOOOOXOOOOOXOOOOXOOOOXOOXXOOOOOOOOOXOOOOOOOOOXOOOOOXOOOOOOOOOOXOOOO
OXXOOXOOOOXOOOOOXXOOOOOOOOOOOOOOOOOOOOOOOOOOOXOXOOOOXOOOOXOOOOOXOOOOOOXXOOOOOOOOOOXOOXOOOOOOOOOOOOOO
OOXOXOOOOOXOOOOOOXXOOOOOOXOOOOOOOOOOXOOOXOXOOOOOOOOOXOOOOOXOOXOOOXOOXXOOOOOOXOOOXOOOOXXOXOOOOOOOOOOO
OOOXOOXOXOOOOOXXOOOOOOOOOOOOOOOOOOXOOOXOOOOOOXOOOOOOOOOXOOOOXXOOOOOOXOOOOOOXOOOOOOOOOOOOOOOOXOOXXOOO
OOXXOOOOOOXOOOXOOXXOXOXOOOOXXXOOOOXOOOOXXOOXOXXOOXOOOXXOOOXXXOOOXOOOXOOOOOOOXOXOOOOOXOOOOXOOOOXOOOOO
XOOOOOXXOOOXOXOXOOOXOOOOOOOOOOOOXOOXOOOOOOOOXXOOOXOOOOOOOOOXXXOOOXOOOOOOOOOOOXOOOOXOOOOXOOOOOOOOOOXO
OOXOOOOOOOOOOOOOOOOOOXOOOOOOOOOOXOOOOOOXOOOXOOOOOXOXOOOOOOOOOOOOOOOOOOXOOOXXXOOOXOOXOOOOXOOOOOOOOOOX
OXOOXXOOXOXOXOOOOOOOOOOOOOOXOOXOOOOOOOOOOOOOOOOOOOOOOOXOOOOOOOOOOOOXOOOXXOOOOXOOOOXOOOOOOOOXXXOOOOOO
OOOOOOOOOOOOOOOOOOOOOOXOOOOOOOXOXOOOOOOOXOOOOOXOOOOOOOOXOOOOOXXXOXOOOXOOOOOXXOOOOOOOOXOOXOXXXOOXXOOO
XOOOOOOOOOOOOOXOOOOOXOXXOOOOOOOOOOXOOOXOXXOXOOOOXOOOOOOOOXOOOOOOOOOOOOOOOOOOOOOOOOOOOOOOOOOXOXOOOOXX
OXOOOOOOOOOOOOXOXOOOXOOOOOOOOOOOOOOOOOXOOOOXOOOOOOOOOOOOOOOXOXOXOOOXOXOOOOOOXOOOOOXOXOOOOXOXXOOOOOOO
OOOOXXOOXXOOOOOOOOOOOOOXOXOOOOOOOOOOOOOOOOOOOOOOOOOOOOOOOOOXXOOOOXXOOOOOOOOOXOOOOOOOOOXOOOOOOOOOOOOO
OOOXOOOOOOOOXOOOOOOOXOXOOOOOOOXXOOOOXOOOOOOOXOOOOOOOOXOOOOOOXOOOXOOXOXOOOOXOXOOOOOOXXXOOOOOXXOOOOOXX
XOXOOOXOOOXOXOOXOOOOOXOOOOXOOOOOOOOXOXOOOXXOOOOXOOOOOOOOOOOOXOOOOOOOOOXOXOOOOXOOOXOOOOOOOXOOOOXOOOOX
XOOOXOOOOOOOOXOOOOOOOXXOOXXOOOOOOOOOOOXOOOOOOOOOXOXOXOOXOOXXOXOOXXXXOOOXXXOOOOOXOOOOOOOOOOOOOOOOOXOO
OOOOOXOOOOOXXOOOXOOOOOOOOOXOXOOOOOOOOOOOOOOOOOOOOXXOOOOOOOOOOXOOOOOOOOOOOOXOOOOOXOOOOOOXOOOOOOOOXOOO
XOOOOOOOOXOOOOOOOOOOOOOXOOOOOOXOOOOOOOOOXOXOOOOOOOOXOOXOXOOOOOOOOOOOOXOXOOOOOOOOOXOOOOOXXOOOOOOOOOOO
OOXOOOOOOOOOOOOOOOOOOOOOOOOOOOOOOOOOOOOOOOOOOXOOOOOOOOOOOOXOOOOOOOOOOOOOXOOOOOOOXOOOOOOOOXOOOOOOOXOO
XOOOXXOOOXOOOOOOOOOOOOOOOOOXXOOXOOOOXOOXOOOOXOOOOOOOOXOOXOXOOXOOOOOOOOXOOXOOOOXOOOOOOOOOOOOOOXOOOOOO
XOOOOOOXOOOOOOOOXOOXOOOOOOOOOOXOOOXXOOOOOOOOOOOOOOOOXOOOOOOOXXOOOOOXOOOXOOXOOOXOOOOOOOOXOOOXOOOOOOOO
OOOOOXOOXOXXOOOOOOOOXOXOOOXXXOOOOOOOXOOOOOXOXOXOOOXOOOOOXOXOOOOOOOOOXOXOXOXOOOOOOOOOXOOOOOOOOOOOOOOO
OOOOOOXOOOOOOOOOOOOOOXOOXOOOOOXXXXOOXOXOOOOOOOOOOOOOOOOOOOOOOOOXOOOOOOOOOOOOXOOOOOXXXXOOOOOOOXOOXOOX
OXOXXOXOOXOOOXOXOOOOOOOOOOXOOOOOOOOOOOOOOOOOOOOOOXOOXOOOOOOOOOOXXXOOOOOXXOXOOOOXOOOOOOXOOOXOXOOXOOOO
OXOOOOOOOXOOXOOOOOOOXOOOOXOXOOOOXOOOXOOXOOOOOOOOXOOOOOOOOOOXOOOOOOOOOOOOOOOOOOOOOOXOOOXOOOOXOXOOOOOO
OOOOOXOOOOOOOOOOOOOOOOOOOOOOOOOXXOOOXOOOOOOOOOOOOOOOXOOOOOOOOOOXOOOXOOXOOOOOOOOOOOOOOOOOOXOOOOOXOOXO
OXOOOOOOOOOXOOOXOXOXOOXXOOOXOOOOOOOOOOOOOOOOOOOOOXOOOOOOOOOOOOOOOOXOOOOOXOOOOOOOOOOXOOOOOOOOOOOOOOOO
OOOXOOOOOOOOOOOOOOOXXOOOOOOOOOOOOXXOOOOOOOOOOOXXOXOOOOOXOXOOOOOOXXXXOOOOOOXXXOOXXOXXOOOXOOOXOXOOOOOO
OOOOOOOOXOOOOOOOOOOOOOOOXOOOOOOOXOOOOOXOOOXOOOOOOOXOOOOXOOOOOOOOOOOOOOOOOXOOXOOXOOOXOOOOOOOOOOOXOOOX
OXOOOOOXXOOXOOXOOOOOOXOOOOXOOOOOXOOOXXXXOOOXOOOOOXOOXOOOOOOOXOXOOXOOOOXOOOOOOOOOOXOOOXOOOOOOOOOOOOOO
OXOOOOOOOOXOOOOOOOXOOOOOXOOOOOOOOOXOOOXOOXOOXOOOOOOOOOOOOOOOOOOOOOOOOOOOOOOOXOOOOOOOOOOOXOOXOXOOOOOO
OOOOOOOOOOOOOOXOOOOXOXOOOOOOXOXOOXOXOOOOOXOOXOOOOOOOOOOOOOXOOXOOOOOOOOOOOOOOOOXOOXOXOOOOOXOOOOOXXOXO
OXOOOOOOOOOOOOOOXOOOOXXXXXOOXOOOXOOXOXOOXOOOOOXOXOOOOOOOOOOOOOOOOOOOXOOOOOOOOOOXOOXOXOOOOOOXOOOOOOOO
OOXOOXOOOOOOOOOOOOXOOXOXXOXOOOOOXXOXXOOXOOOXOOOOOOOXOOOOOOOOOOXOXOOOOOXOXOOOOOOOOOOOOOOOOOOOOOOOOOXO
OOOOXOXOOOXOOOOXOOOOOOOXOOOOOOOOXOOOOXOXXOOOOOOOXOOOXOOOOOOOOOXXOOXOOOOOXOOOXOOXOOOOOOOXOXOOOOOOOOOO
OOOOOOOOXOXOOOOOXOOOXXOOOOOXOOOOOOOOOXOOOOOOOOOOOOXOOOOOXOOOOOOOOOOOOOOOOXOOOOOOOOXXOOOOOOOXOOOOOXXX
OOXOXOXXOOXOOOOOOOOOOXOOOXXOXOOOXOOOOOOOOOOXOOOXOOOOOXOOOOOOOOOOOOOXOOOOOOOOOOXOXOOOOOXOOOOOXXOOOOOO
OXXXOOOXOXOXOOOXOOXXOOOOOXXOOOOOOXOOOOXOOOOOOXOOOOOOXOOXOOXXXOOOOXOOOOOOOOXOOOOOOXOOOOOOOOXXOXOOXOOO
OOOOOOOOOOOXOOOOXOOOOOXXOOOOOOOOOOOXXXXXXOXOOOOXOXOOOOXOOOOXXOOOOOOOOOOOOOOOOXOOOXOOOOOOOXOOOOOXXOOO
OXOXOOOOOOOOXOXOOOOOOOOOXOOOOOOXOOXOOOXOXOXOOOOOXOOOOOOOOOOOOXOOXOOOOOOOXXXOOOXOOOOOOOOOOOOOOOOOXXOX
OOOOOOOOOOOOOOOOOOOOOOOOOOOOOXOOOOOXOOOOOOOOOOOOOOOXOOOOOOXOXOOOOOOOOOOOOOOOOOOOOOXOOOXOOOOOOXOOOOOX
OXOOOOOOOOXOOOOOOOOOOOOXOOOOOOXOOOOOOOOXOOXOOOOOOOOOXOOOOOOOOXOOOOOXOOOOOOXOXXOOOXOOOOXOOOOOOOOOOOOO
OOXOOOOOXOXOOOOXOOOOXOOOOOOOOOOXOOOOOOOOOOXOOOOOXOOOOOXOOOXOOXOXOOOOOOXXOOOXOOOXOOOOOOOOOOOOOXOOOOOO
OOOOOOOOOOOOOOOOOOOOOOOOOOOOXOOOXOOXOOOXOOOOOXOOOXOOOOXOOOOOOOXOOOOXOOOOOOXOOOOXOOOOOOXXOOXOOOOOXOOO
OOOOOOOOOOOXOOXOOOOOOOOOOXXOOOXXOXOOOXOOOOOOOXOOXOXOOOOOOOXXOOOOOOOOOOOOOOOXOXOXOOOOOOXXOOOOOOXOOOXO
OOOOOOOOOOOOOOOOOOOOOOXOOOOXOOOOOOOXOOOOOXOOOOOOOOXOOOOOXOXXOOOOOXXXOOOOXOOOOOOOOOOOOOOOOOXOOXOOOOOO
OOOOOOXOOOOOOOOOXOOOOOXOXOOOOOOOOOOXOXXXOOOXOOOOOOOOOOOOXOOOXOOXOOOOOXXOXOOOOXOOOOXOOOOOOOOOOOOOXOOO
OOOOOOOOXOOOOXOXOXOOXOOOOOOXOXOOXOOOOXOOOOOXOOOOOOOOOXXOOOOOOOOXOOXOOOOOXXOOOOXOXOOOOOOOOOOOOOOOOOOO
OOXOXOOOXOOOOOOXOOOOOXOOOOOOOOOXOOOOOOOOOXXOOOOOOOOXOOOOOOOOOOOXOXOXXOOOOOOOOOOXOOOOOXOOOOOOXOOOOOOO
OXXXOOXOOOOOOXOOXOOOOOOXOOOOXXOOXOOOOOOOOXOOOOOXOOOOOOOOOOOOXOOOOOOOOOOOOXOOOOXOOOOOOOOOOOOOOOOOOOOO
OXOOXOOOXOOOOXOXOOXOOOOXOOXXOOXOOOOOXOFOOOXOOOOXOOOOOOXOOOXOXOOOOOXOOOOXXOOOOOOOOOOOOOOOXOOXOOOOOXOX
OOXXXXOXOOOXOOXOXOOOOOOOOOOOXOOXOOOOOOOOOXOOOOOOOOOOXOOOOO*XOXOXOOOOOOOOOOOOOOXXOXOOOOOOXOOXOXOOOXOO
XOOXXOOOOOOXOOXXOOXOOOOOXOXOOXOOOOOOOXOOOXOOXOOOOXOOXOOOOXOOOOOOOOXOOOOOOOOOOOOOOXOOOOOOOOOOOOXOOOOO
OOOOOOOOOOXOOOOOXOOOOOOOOOXOOOOOOOOXXOOOOXOOOOOOOOOXXOOOOOOXOOXXOOOOOOOXXOOXXOOOOOXOOOOOOOOXOOOOOOXO
OXOOXOOXOXOOOOOOOXOOOXOOOXOXXOOOOOOOOOOOOOXOXOOOOOOOXOOXOOXXOOOOXOOOOOOOOOOOOOOOOOOOOOOOOOOOXXOOOOXO
XOOOOOOOOOXOOOOOXOOXOOOOOOOOOOOOOOOXOOOXOXOXOXOOOOOOOOOOOOOOOXOOOOOXXOOOOXOOOOOOXOXOOXOOXOXOOOXOOOOO
OXXOOOOOOOOOOOOXOOOXOOOOOOOXOOXOOOOOOOXOOOOXOOXOXOOOOOOXOOOOOXXOOOXOOOOOOOOOOOOXOOOOOOXOXOXOOOOOXXXX
XOOOOXOXOOOOOOOOXOOOOOOOOXOOOOOXOOXXOOOOOOOXOOOOOOOOOOXXOOXOOOXOOXOOOOOOOOOOXOXOOOOOOXOXXOOOOOOOOOOX
OOOOXOOOOOOOOOOOOOOOOOXXXOXOOOOOOOOXOOOXOOOXXXOOOOXOOOOXOXOOOOOOOXOOOXOOOOOOXOOOOOXOOOXOOOXOXOOOXOXX
OOXOOOOOOOXOOOOOXXOOXOOOOOOOXOOOOXOOXOOOOOOOOOXOOOXOOOOOOXOOOOOXXOXOOOOOOOOXOOOOOOOOXOOOOOOOOOOXOXOO
XXOOOOOOOOOOOXOXOOOOOOOXOOOXOOOOOOOOOXOXOOOOOOOOOOOOOOOOXOOOOOOOOOOOOOXXOOOOOOOOOOXOOOOOOOOOOXOOOOOO
OOOOOXOOXXOOOOOOXOOOOOOXOOOOOOOOOXOOOOOOXOOOOOOXXOOOOOOOOOOOOOXOOXOOOOOOOOXXOOOXXXOOOOXOOOOXOOXOOXOO
OXXOXXOOOOOXXOOOXOOOOOXOOOOOOOOOXOOOOOOOOOOOOOOOXXOOOOOOOOOOOOOOXOOOOOOOOOXOOOOOOOOXOXOOXOOOOXOOOOOX
OOOXXOOOOOOXXOOXOOXXOOOOOOOOOOOOOXOOOOOOOOXOXOXXXOOOOXOOOOOOOOOOOOOOXOOOOOOOOOOOOOOXOOOOOOOOOOOOOOOO
OOXOOOOOOOOOXOOOOXOOOOXXXOOOOOOOOOOOOOOOOXXOOOOOOOOXXOXOOOOOOXOOXOOOOOOOXOXOOOOXOOOOOOOOOOOOOOOOOOOO
OOOOOXOOXOOOOOOOOOXOOOXXOXXOXOOOOOOXOXOOOOOOOXXOXXOOOOXOOOOOOOOXOOOOOXXOOOOOOXOOOOOXOXOOOOOXOOOOXOOO
XOOOOOOXOOOOOOOOXOOXXOOXOOOOXOOOXOOOXOOOXOOOOXOOXOXOOOOOOOXOOOOOXOOOOOOOOOOOOOOOXOOOOOXXOOXOXXOOOOOO
OOOOOOOOOXOOOOOXOOOOOOOOOOOOXXOOOOXOOOOOOOOOOOOOXOOOOOOOOOOOXOOXOXOOOOOXOOOOOXXOXOOOOOOOOOOOOOOOOOOO
OXOOOXXXOOOOOXOOOOOOOOOOOOOOOXOOOOOOOOOOOOOOOXXXOOOOOOOOOOXOXOOOOXOXOOOXOOOOOOOOOOOOOOOOOOXOOOOOOOXO
OOOOOOOOOOOOOOXOOOOOXOOOOOOOOOOXOXOOOOXOOOOOOOOOOOOXOOOOOOXOOOOXOXOXOOOOOOOOOOOOOXOOOOOXXOOOOOOXOOOO
OOOOOOXXXOOOOOXOOOOOXOXOXOOOOOOOOOOXOXOOOOOOOOOOOOOXOXOOOOOXOOOOOOXOOOOOOOOOOOXOXOOXOOOOOOOOXOOOOOOO
OOOOOOOXOXOOXXOOOOOOXOOOOOOOOOOOOOOXOXOOOOOXOOOOOOOOXOOXOOOXXOOXOOOXOXOOOOOOXOOXXOOOOOOOXXOOXXOOOXXO
OOOOOOOOOOOOOOOOXOOOOOXOXOOOXOOOOOOOOOOOOOXOOOOOOOXXOOXOOOOXOOOOOXXOOOOXOOXOXOOXXOOOOOOOOXOOXOOXXXOO
XOOOXOOXXOOOOOOOOOOOOOOOOXOXOOOXOOOOOOXXOOOOOOOXOOXOXXOOOOOXOOOOOOOXOOOOOOOOOOOOOXOOOXOOOOOOXOOOOXOO
OOOXOOOOOOOOOOOOOOOOOOOOXOOOOOOOOXOOOOXOXXXOOOOOOOOOOXOOOOOXOOOOOOOOOOXOOOOOOOOOXOOOOXOOXOOOOOOOOOOO
OOOOOXOOOXOOOOOOOOOOOOOOOOXOOOOOOXOOXOXOOOXOOXOXOOOOOOXOOXOXOXOOOOOOOXOXXOXOOXXOOOOOOXOOOOXXOOOOOXOO
OOOOOOOXOOOOOOOXOOOOOOOOOOOOXOOOXOOOOOXOXOOXOOOXXOOOXOOOOOOOOOOOOOOOOOOOOOOOOXOOXOOOXXOXOOOOXOOOOOOO
OXOOOOXXOXOOXOOOOOOOOXOOXOOOOOOOOOOOOOOOOOOOXOOXOOOOOOXOOOOOOXOOXOOOOOOOXOXOOOOXOXOXOOOOOOOOXOOOOXOO
OOOOOOOOOOOOOOOOXOOOOXXOOOOXOOOOXOOOOOOOOOOOOOOOOOOXOOOOOOOOOOOOOOXOXXXOOOOXXOOXOOXXOOOOOOOOOOOOOOOO
OXOOXOOOOOOOOOOOXOXOXOOXXOOOOOOOXXOOOOOOOOXOOOOOOOXOOOOOOOOOOXXOOOOOXXOOOOOXOOOOOOOXOOOXOOOOOOOOOOOO
OOOOOXOOXOXOOXOOOXOXXOOOOOOOOOOOOXOOOOOOOXOOXOOOOOOOOXOOOOXOXXXOOOXOOOOOOOOXOOOOOOOOOOOOXOOOXOOOOOOX
OOOOOOOOOXOXOXOOXXOXOOOOOOOXOOOOOOOOOOOOOOOXXXOOOOOOXXOOOOOOXOOOXOOOXOOOOOOOOOOOOOXOOOOOXOXOOOOOOOOO
XOOOOXOXXOOOOOOXOOXOOOOOXOOOOXOOOOOOOOOXXXOOOOOOOOOOOOOXOOOOOOOXOXOXOOOXOOOXOOOOOOOOXXOOOOXXOXOOOOOO
XOOOOOOOOOOOXOOOXOOXOXOOXOOXOOOOOOXXOOOXOXOXOOOOOOXOOOXOOOOOOOOOXOOOOOXOOOOOXOOOOXXXOXXOXOOOOOOXOOOO
OOOOOOOOOOOOOOOOOOOOOOOOOOOXOOXOOOOOOOXOOOOOOOOXOOOOOOOXXXOXXOOOXOOOOOOOOXOOOOXOOOOOOOOOOOOOXXOOOOOO
OOXOOOOOXOOOOOOOXOOOOOOOXOXOOOOOOOXOOOOXXOOOOOOOXOOXXOOOOOOOOOXOOOOOOOOOOXXOOOOXOXOOOOOXOOOOOOOOOOOO
