OOOOOXOOXOOOXOXXOOXOXOOOOOXOOXOOOOOOOOOXOOOOOOOOOOXOXOOOOOOOOOOOOOXOOOOOOXOXOOOOOOOXOOOOOOOOOOXOOOOX
OOOOOOOOOOOXOOOOOOOOOOOOOOOOOOOOOOOOOOOXOOXOXXOXOOOXXXOXOOOOOOOXOOOOOXOOOOOOOXOOOOOOOOOOXOOOOOOOOOOO
XOOOOOOOOOOOOOOOOOOOOXOOOOOOOXOXOOOOOOOOOOOOOOOOOOOOOOOOOOOOOXOOOXXXOOXOOOOOOOOOOOOOOXOXXXOOOXOOOOOO
OOOOXOXOOOOOOOOOOOXOOOOOOOOOOOOXOXOOOOOOOOXOOOOOXOOOOOOOXOOOOOOOOOOOOOOOOXOOOOOOOXOOOOOOOXOOOOOOOOXO
OOOOOXOOOOOXOOXOOXOOOOOOOOOOOOOOOOXOOOOOOOOOXOXOOOOXOXOOOOOOOOOOOOOOOOXOOOOOOOOOOXOXOOXOOOOXOOXOOOXO
XOOOOOOOOOOOXOXOXOOOOOOOOOOOOOOOOOOOOOOOOOXOXOOOOXXOOOOOOOOOOOXXOOXOXOXOXOXOOOOXOXXXOOOOOOXOOXOOOXOO
OOOOXXOOOOOXOOOOOOXOOOOOOOOOOXOOOXOOOOXOOOOXXXXOXXOOOXOOOOXOOOOOOOOOOOOOOOOXOOOOOOOXXOOOXOXOOOOOOOOO
OOOOXOOOOOOOOOOOOOOOOOOXOOXOOOOXXOOXOOXOXOOOOOOXOOOXOOOOOOOOOOOOXOOOOXOOOOOOOOOOOXOOOOXOOXXOXXOOXOOO
XOOOOXOOOXOOOXOOOOOOOOOOOOOOXOOXOOOOXXOOOOOOOOOXOOOOOOXOXOOOXOOOOOOOOOOOOOOOOXOOXOXOOXOXOOXXOOOXOOOO
OOXOOOOOOOXOOOXOOOOOOXOOOOOOXOOOOOOOOOOOOOOOOOOOXOXXOOOOOOOOOOOOOOOOOOOOOXOOOOOXOOOOOXXXOOOOOXOOOOXO
OOXOXOOOOXOOOOOOOOXOXOOOOOOOOOOOOOOXOOXOXOOOOOOOOOOOOXOOOOOOOOOOOOOOOOOOOOOOOOOXOOOOOXOOOOXOOOOOOOOO
OOOXOOOXOOOOXXOXXOXOOOXOXXOOOOOXOXXOOOOXOOOOXOOOXOOXOOXOOOOOOOOOOXOXOOOXOXOOOOXXOXOOXOXOOXOOOOXOXOOO
OOOOOOOXOXOOOOXXXOOXOOOOOXOOOOOOOOOOXOOOOOXXOOOOOOOOOOOOXOOOOOOOOOOOXOOOOOOOOXOOOOOOOOXOOOOOOOOOXOOO
XOOOOXOOOOXOOOOXXXXOOOOXXOOOOOOOOOOOOXOOOOOXOOOOOXXOOOXOOOOXOOOOOOOOOOOOXXOOOOOOOOXOOOOOOOOXOOXOOXXO
OOOOOOOOXOOOOOXOOOOOXXOOOOOOOOOOOOOXOOOOOOOOOOOOOOOOXOOOOXOOXOOOOXOOXOOOOOXOOOOOOOOOXOOOOOOOOOOOOXXO
XOOOOOOOOXOOXOOOXOOOOOOOXOOOOOOOOOOOOXOOOOXOXOOXOOXOOOXOOXOOOOXOXXOOOOOOOXOOOOOOOOXXOOOOOOOXOOOOXOOO
XXXOOOOOOOOOXOOXOOOOOOXOOOOOOOOOOXOXOXOOOXOOXOXOOOXOOXOOXOOOOXXOOOOOOOOXXOOOOOOOOOOXOOOOOOOOOOOOOXOX
XXOOOOOOXOOOOOXOOOOXOOXXOOOOOOXXOXOXOOXOOOOOXOOOOOOOOXOOOOOOOOOOOOXOOXXOOOOOXOOOOOOOOOOOOOOOOOOOOOOO
XOOOOOOOOOOOOOOOOOOXOOOOOOOOOOOOOOOOOXOOOOOXOXOOOOOOOOXOOOOOOOOOOOOXOXOXOOOOOOOOOOXOXOOOOOOXOOOOOOOO
OOOXOOOOOOOOOOOOXOOOOOXOOOOOOOOOXOOXOOOOXOOOOOOOOOOXOOOOOOOOOOOOOOOOOOXOXOOXOXOXOOOXOOOOOOOOXOXOXOOX
OOOXOOOOOOOOXOOXOOXOOOXOOOXOOOXXOOOOOOOOOOOOOOOOOXXOOOOOOOOOOXOOOOOOOOOOOOOOOOXOOOOXOOOOOOOOOOOXOOOO
OXOOOOXXOOOXOOXOOOXOOOXOOOOOOOXOOOOOOOOXOXOOOOOOOOOOXOOOOOXXOOOOOOXOXXOOOOOOOOOOXOOOOOOOXOXOOOXXOOOO
OXOOOOOOOOOOOOXXOOOOOOOOOOOOXOOOOOXOXOXXOXOOOOOOOOOOOOOOXOOOOOOOOOOXOXOOOXXOXOXOOOXOOOOOOOOOOOXOOOOX
OOOOOOXOXOOOOOOXOOXXXXOOOOOOOOOOOOOOOOOOOXOOOOOXOOOXXOOOOOOOXOXOOOOOOOOOOOXOOOOXOOOOOOOOOOOXOXOOOXOO
OOOOXOOOOOOOOOXXOOOOOOOXOXOOOOXOOOOOOOOXOXOOOOOOOOOOOXOOOOOOOOOXOXOOOOOOOOOOOXOOOXOOOOOXOXOOXOXOOOOO
OOXOOOOOXOXOOOOXOOOOOOOOOOOOOOOOOOOOOOOXOOOOOOOOOXOOOOXOOOOOOOXOOOOOXXOOOOOOOOOOXOOOOXOOOOOOOOOXOOOO
OOOOOOOOOOOXOXOOOOOOOXOOOOOOOXOOOOOOXOOOOOOOOOOOOOOXOOXOOOOOOXOXOOOXOOOXOOOOOOXOOOOOXOOOXOXOOOOOXOOO
XOOOOXOOOOOOOOOOOXOOOOOOOOOOOOOXOOXOOOOXOOOOOOOOOOOOOOOOOXOOOOOOOOOOXOOOOOOOOOOOXOOXOOOOOOOOOOOOOOOO
OOOOOOOOXOOXXOOOOXOOOOOOOOOOOXOOOOXOOXXOXOOOOOOOOOXXOOOOOOOXOOOOOOOOOOOOOOOOOOOOOOOOOOOOOXOXOOOOOOOO
OOOOOOOOOOOOOOXXXOOOOOOOOOOOOOOOOOOOXOOOOXOXOOXOOOXOXOOOOXOXOOOOOOXOOOXOOOOOOOOOOOOOOOOXOOOOOXOOXOOO
OOOOOOOOOXOOXOOOOOXOOOOXXOOOOXOOOOOOOOOOOOOOOOOOOOOOOOOOOOOOOOOOOOOOOOOOOOOOOOOOOOOXXOOOOXOOXOOOOOOO
XXOOOOOOOOOOOOOOOOOXOOXOOOOOXOOXOOXOOOOOXOXOOOOOOOXOOOOOOOOOXOOOOOOXXOOXOOOOOOOOOOOXOOOOOOOOOOOOOOOO
OXOOOOXOOOOXOOOOXOOOXOXOXOOOOOOOXOOXOXOOOOOOXXOOOOOXOOOOXOOOOOOOOOOOXOOOOOOOOOOOOOOXOXOOOOOOOOOOOOXO
OOOOOOOOOOOOXXXOOOOOOXOOOOOOOOOOOOOOOOOOOOOOXOXOOOXOOOOOXOOXOOOOOOXOOOXOOOOOOOOOOOOOOOXXOXOOXOOOOOXO
OOOOOXOXOXOOOXOXXOOOOOOOOXOXOOXOOOOOXOXOOOXOOXOOOOOOXOOOOOOXOOOOOOOOOXOOXOXOXOOOOXOOOOOXOXOOOOOXXOXO
OXOOOOOOOOOOOXXOOXOOXOXOOOOOOOOOXOOOOOOOOOOOOOXOOOOXOOOOOOOOXOOOOOOOOOOOOOXOOOOOXOOOOXOOOXOOOOOOOXXX
OXOOOOXOOXOOOOOOXOOOOOOXOXOOOXOXXOOOOOOOOOOOXOOXOOOOOOOXXXOOOOOOOXOOXOOOOOOOOOOOOOOXOOOOOOOOXOOOOOOO
OOOOOXOOOXXXOOOOXOOOOXXOOOOOOOOOXOOOOOOXOOOOOOOOOOOOOXXOOOOOOOOOOOOOOXOOXOOOOOOXXXOOOOXOOOOOOXOOOOOO
OOOOOOOXOXXOOOOOOOOOOXXOOXXOXXOOOOXOOOOOOXOOXXOOXOOOXOOOOOOOOOOOXOOXOOOOOOOOOOOOOXOXOXOOXOOOOOOOOOOO
OOOOXOOXXOOOOXOXOOOOOOOOOXXOOOXOOOOXXXOOOOOOXOOXOXOOOOOOOOOOOOOOOOXOXOOOOXOOXOXOOOOXOOOOOOOOOOOOOOOO
XXOOOOOXXXOOOXOOOOOOXXOOOOOXOOOOOOOOOOOOOOOXOOXOOOXOXOOOOXOOOOOOOOXOOOOXXOOOOXXOOOXXOOOXOOOOOOOXOOXX
OOOXOOOOXOOXOOXOOOOOOOXXXOOXOOXOOOOOOOOOOXOOOXXOXOXOOOOOOOOOOXXXOOOOOXOOOOOOXOXOOOXOXOOOOOXOOXXOOOOX
OOOOOOOOOOOXOXOOOOXOOOOOXOOXOOXXOOOOOOOOOOOOXOOXOOOOOOOOXOOOOOOOOOXOOOOOOOOXOOOOXOXXXXOXOOOXOOOOOOOO
OOOXOOOOOOOOOOOXOOOOOOOOOOOOOXOOOOOOOOOXOOOOOOOOOOXOOXOOOOOOOOOOOOOOXOOOOOOOOOOOOXOOOOOOOOOOOOOOOOOO
OOOXOOOXOOOOOOOOXOOOXOOOOOXOOOOOOOOOOOOOOOOOOOOXOOOOOOOOOOOOXXXOOXXOOOOOOOXOXOOOOOOOOXOOOXOXOOXXXOOX
OXOOOOOOOXOXXOXOOOOOOOOOOOOOOXOXOOOOOXXOOOOOXOOOXOOOOXXOOOXOOOOOOOXOOOOOOOOOXXOXOOXOOOOOOXXOXOOOOOOO
OOOOXOOXOOOOOOOOOOOOOXOOO*OOXOXXOOOOOOOOOXOOOXOOOXOOOOXOXOOXOOOXOOOOXOXOOOOOOXOOOXOOOOOOOOOOOOOOOOOO
OOXOXOOXOXOOOXOOOOOOOOOOOOOXOOOOXOOOXOOOOOOOOOOOOXOOXOXOOXOXOOOXXOOOOOOOOXOOOOOOOOOOOOOOOOOOOXOOOOOO
OOOOOOOOXXOOOOXOOOOOOOOOOOOOOOOOOOOOXOOOOOOOOXXOOOOOOOOOOOXOXOOOOOOOOOXOOOOOOOOXXOXOXOOOOOOOOOOXXOOX
OXOXOOOOOOOOOOOOXOOXXOOXXOOOOXOXOOOXOOXXOOOXOOOOOOOOOOOOOOOXOXOOOOOXOOOOOOOOOOOOOOOOOOXOOOOOXXOOOOOX
OOOOOOXXOOOOOXOOOOXXOXXOOOOOOOOXOXXOOOOOOOXOOOOOOOOOOOXOOOXOXOOOOOXOOOOOOOOOOXOOOOOOXOOOOOOOXOOOOOOO
OOOOXXOOOOOOOOOOOOOXOOOOOOOXOOOOXOOOXOOXXOOXOOOOOOOXOOOOOOOOOOOOOOXOXOOOOXOOOOOXXOOOXOOOXXOOOXOOOOOO
OXOXOOXXOXOOOOOXOOOOOOOOOOXOOOOOOOOOOXOOOOOOOOXOOOOOOOXOOXOOOOXOOXXOOOOOOOOOOOOXOOOXOOOOOOOXXOOOOXOX
OOXOOOOOOOOOOOOOOOOOOOOOOOOOOOOOOOOXOOXOXOOXOOOOOOOOOOOOOOOOOOOOOOOOOOOOXOOOOOOOOXOOOXOOXOOXOOOXOOXO
XOOOOOOOXOOOOOOOOOOOOOOOOXOOXOOOOOOXOOXOOXOXOXOOOOOOOOOOOOOXXOOXOOXXOOOOXXXXOOOOXXOOOOOOOOOOOOOOOOOO
OXOXOOOOOXOOOXXOOOOXFOOXOOOOOOXXXOOXOOOXOXOOXOOOOOOOOOOOOXOXOOOOOOOOXOXXOOOOOOOXXOOOOOXOOXOOOOOOOOXO
OOOXOXOXOOOXXOOXOOOOOOXOXOXOOOOOOOOOOOXOOXOXOOOOOXOOOOOOOOXOOOOOXOOOOXOOOOXOOXOOOXOOOOOOOOXOOOOOOOOO
OOOOOOOXXXOOOOOOXXOOOOOOXOOOOOOOXOOOOOOOXOOOOOOOOOOOXXXXOOXOOXOXOOOOXOOXXOOOOOOXOOOOXOOOOOXOXOOXOOOO
XOOOOXOOOOXOOOXOXOOOOOOOOXOXXOXOOXOOOOXOXOOOXOXOOOOOOOXOXOOXOOOOOOOOXOOOOOOOOOOXOOXOOOOOOOOOXOXOOOOO
OOOOXOOOOOOOOOOOOXOOOOOOOOOOOOXOOOOOOOOOOOOOOOOOOOOOOOOOOOXOXXOOXXXOOOOOOOOOOOOOXOXXOOOOOXOOOOOOOOOO
OOXOXOOOOXOOOOOXOOOOXXOOOXOOOOOOXOOOOOXOOOOXOOOOOOOOOOOXOOOOOOOXOOOOOXOOXOXOOOOOXOXOXOOOOOOOXOOOOXOO
OOXOOOOOOOXOXOOXOOOOOXOOOOOOOXXOOOXOOOXOOXOOOXXOOOOOOOXOOXXOXXXOOOOOOOOOOOXOXXOOOOOOOOOOOOOOOOOOOOXO
OOOOOOOOOXOXOOOOOXOXOOOOOOOOOOOOOOOOOOOOOOOOXOOOOOOOOXOOOOOXXOOOXOOOOOOOOOOXOOOOOOXOOOXOOOOOOOXOOOXO
OOOOXOOOOOOOOXOOOOOOOOOXOOOXXOOOXOXOOOOXXOOOOXOOOXOOOOOOOXOOOOOOOOOOOOOXOXOOOOOOOOOOOOOXXOXOOOOXOOOO
OOOOOXXOOOOXOXOOOOOOOXOOOOXOOXOOOOOOOOOOOOOOOOOOOOOXXOOOOOOOOOOXOOOOXOOOOOOXOXOXXOOOOOOOOOOOOOOXXXOO
OXOOOOOXOOXXOOXOOOXOOOOOOXOXOOXOOOOOOOOOOOOOOOOOOOOXOOOOOOXOXOOOXXOOOOOOOOOXOOOOOOOOXOOXOOOOXXOOOOOO
OOXOOOXOOOOOOOOOOOOXOXOOOOOOOOOXOOOOXOOOOOOOOOOOOOOOOXOOOOOOXOOOOOOOOOOOOOOOXOXXOXOXOXOOOOOOXOOOXXXO
OOOXOXXOOOOOOOOOOOOOOOXOOOOOOOOOOOOOOOXOXOXOXXOOOOXOXOXOOOOXOXOXOOOOOOOOOOXOOOOOOOOOOOOOOOXOOOOXOOOX
XOOOOOOOOOOXOOOOXOOOOOOOOXOOOOOOOOOOOOOXOOOXOOOOOOOOOOOOXOOOOOOOOOXOOOXOXOOOOOOOOOOXOOOOOXOOOOOOXXOO
OOOOOOXOOOOOOXOOOOOOOXOOOOOOOOXOOOOOOOOOOOOOOOOOOXXOOOOOOOOOXOOOOOOOXOOXOOOXOOOOOOOOOOXXOOOOOOOOOOOO
OOXOOOOOXOXOOXOOOOXOXOXOOOOXOOXOOOOXOOXOOXOOOXOXOOOOXOXOOOOXOOOOOXOOOOOXXOXOOOXOOOXOXOOOOXOOXOOOOOOO
OXOXOOOOOOOOOOOOOOOXXOOOOOOOOOOXOOOOOOOOXOOOOOXXXOOOOOXXOXOOOXOOOOXXOOOOOOOOXOOOOXXOOXXOOOOOXXOOOOOO
OOOOOOOOXOOOOXOXOOXOXOOOOOXOOOOOOOOOOOXOXOXOOOOOOOOOOOOXOXOOOOOOOOOOOXOOOOXOXOXOOOOOOOOOOXXXOOOOOOOO
OOOOOOOOOOXOXXXOOOXOOOXOOOOOOOOOOOOOOXOOXXOOOOOXOOOOOOOOOXOOOOOOOOXOOOOOOOOOOOOOXOOOOOOOXXOOXOXXOOOO
OOOOOOXOOXOOXOOXOOOOOOXOOXOOOOOOOOXOOXOOOOOOOOOOXXOOOOXOOOOOOOOOOOOOOOOOOOOOOOOOXOOOOOOOOOOXOXOOOXOO
OOOOOOXOOOXOXOOOOOOOOOOXOXOOOOOOOOOOXOOOOOOOOOOXOOOXOOXOXOXXOOXOOOOXOOOOOOOOOXXXOOOOOOOOXOOOXOOOXOOX
OOOOOXOOXOXOOXOXOOOOOOOOOOOXOOOOOOOOOOOXXOXOOOOXOOOOOOOOOXOOOOOOOOXOOOOOXOXOOOOXOOOOOXOOOOOOXOOOXOOO
OOOXOOXOOOOOXOOOOOOOOOOOOOOOOOOOOOOOOOOOOOXOOOOOOOOOOOOOOOXOOOOOOXOOXOXXXXOOOOOOXOOOOOOOXOOOOOOOOXOO
OXXXXOOOOOOXXXOOOOOOOOOOOOOOXOXXOOXOOXOOOOOOOOXOOXOOOOOOOOXXOOOOOOOOXOOOOXOOOXOOOOOOXOOOOXOOXXOXOOOO
XOOOOOOXOXOOOOOXXOOOOOOOOOOOXOOOOOOOOXOOOXOOOXOOOOXOOOOOOOOOOXOOOOXOOOOOOOOOOOOOOOXOOXOOXOOOOOOXXXOO
XOOOOOOOXOOOOOXOOOOOOXOXOOXOXOXOOOOOOOOOOXXOOOOOOOOOOOXOOOOOXOOXOXOXOOOOOOOOXOXOOXXOOOOOOOOXXXOOOOOO
OOOOXOOOOOOOXOXOOXOOOXOOXOXOOOOOOOOOOXOOOOOOOOOOOXOOXOOXOOOOOOXOOOXOOOOOOXOXOOOOOOOXOOOOOOOXOOOXOXXO
OXOOOOOOOOOOXOOOOOOOOXOOOOOOOOOOXOXXOXOXOOOOOOOXOXOXOOOOXOOXOXOOOOXOOOOOOOOXOOOOXOOOXOOOOOOOOOOOOOOO
XOOOOOOOOOOOOOOOOOOOOOOOOOOOOOOOOOOOOXXOOOOOXOOOXXXOXXXXOOOXOOOOOOOOOOXXOOOOOXOOOOOOOOOOXOXOOOOOOXXO
OOOOXXXOXOOXOOOOOXOOOOOOOXOOOOXOOOOOOOOOOOXOXXOOOOOOXOOXOOOOOOOOOXOOOXOXOOXOOOOOXOOXOOOOXOOOXOOOOOOO
OOOOOOOOOOOOOOOOOOXOOOOOOOXOOOOOXOOOOOOOOXOOOXOOXOOOXOOOXOOOOOOOOOXOOOOOOOOOOXOOOOOOXOOOOOXXOOXOOOOO
OOOOOOOOOOOXOOOOOOOOOOXXXOXOOOXOOOOOOOOOOOOXXXOOOOOOOOOOOOOOOOXOOOXOOOOOOOOOOXOOOOOOXOOOOOOOOOOOOOOO
OXOOXOOOOOOOOOOOXXOOXOOOOOOOOXOOOOOOXOXXOOOOOOOXOOXOOOOOOOOOXOOXOOOOXOOOXOOOOOOXOOOOOOOXOOOOOOOOXOOO
OXOOOOOOOOOOOOXOOOOXOOOOOOXOXOXOOXOXOOOOOOOOOOXOOXXXOOOOOOOOOOOOOOOXOXXXOOOOOXOOOXOXXOOOXOOOXOXOOOOO
OOOOOOOOOOOOXOOXOOOOOOOOOOOOOOOOOOOOOXOOXOOOOXOXOXOOXOOOXOOXOOOOOOOOOOOOOOOXOXOOOXOOOOOOOOOOOOOOXOOO
OOOXOXOXOOOOOXOOXOOOXXOOXOOOOOOOXOOOOXOOOOOOOXOXOOXOOOOOOXOOOOOOOXOOOOOOOOOOOOOXXOOOOOOOOOOOOOOOOOOX
OOXOOOOOOOOOOOXOXOOXOOOOOOOOXOXOOXXXOOOXOOXOOOOOOOOOOOOOOOOOOOOXOOOOOOXOOOOXXOOOOOOOOXOOOOOOOOOOOOOX
OXOXOOOOOOOOOOXOXXOOOOOOXOOOXXOXOOOOXOOOOXXOOOXOOXOOOXOOOOOOXXOOOOOOOOOOOOOOXOOOXOXXXXXXXOOOOOOOOOOO
OOOOOXXOOOOOOOXOXXOXOXOOOXOOXXOXOOOOOOOXOOOXOOOOOOOOOOXOOOOXOOOOXOOOOOOOOOOOOOOOXOOOOOOXOOXOXOOOOOOO
OOOXOOOOOOOOOOOOOOOOOOOXOOOOXOOOXOOOOOXOOOOOOOOXOOOOOOXOOOOOOOOOOOOOOOOOOXXOOOOOOOOOXOOOOOOOOXXXOXOO
XXXOOOOXXOOOOOOXOOOOXOOXOXOXOOOOOOOXOOOOOOOXOXOOOOXOOOOOOOOOOOOXOXOOOXOOOOOOOOOOOOOOOXXOXOXOOOOOOOOO
OOOOXXXOOOOOOOXOOOOOOOOOOXOXOOOOOOXOOOOOOOXOOOOXOOOOOOOOOXOOXOOOXXOOOOOOOOOOOOOXOOOXOOOOXXOOOOOXOOOO
XOOXOOOOOOXOOOOOOOOOOXOOOOOXOOOOOOOXOOOOOOOOOOXOOOOOOOOXOOOOOOXOOXOOOOOXXOOOOOOXOOOOOOXOOOOOXOOOOOOX
OOOOOOXOOXXXOOOOOOOOXOOOOXOXOOOOOOOOXOOOOOOXXXOOOOOOOXOXOOOOOOOXOOOXOOOOOOOOOOXXXOOOOOOOOOOOOOOOOOOO
OOOOXOOXOOOOOOXOOOXOOXXOOOOOOOOXOOOOOOOOOOOOOOOOXOOOXOOOXOOOOOXOOOXOOOOOOOOOOOOOOOXOXOOXOOXOOOOOOOOO
